rank;playerName;expressoNb;profit;totalBuyin;totalJackpot;places1;places2;places3;totalX2;totalX4;totalX6;totalX10;totalX20;totalX50;totalX200;totalX1000;totalX10000;averageBuyin;itmPercent;effectiveRake;totalRake;challengePrize;profitPostChall;miles;milesD3;milesD4;milesD5;milesRedD
1;Petonbet;1708;-2025;52875;139500;608;631;469;1306;271;118;12;1;0;0;0;0;30.96;35.6;12.06;3701.25;2250;225;14805;59220;66622.5;74025;88830
3;unasmonfrere;1597;-2100;79550;214500;590;550;457;1222;241;113;20;1;0;0;0;0;49.81;36.94;10.12;5568.5;1000;-1100;22274;89096;100233;111370;133644
4;Hey_Jude;1263;-1075;31575;85250;453;414;396;952;206;97;6;2;0;0;0;0;25;35.87;10;2210.25;750;-325;8841;35364;39784.5;44205;53046
5;Mepslol;1079;-1025;26975;70550;409;379;291;834;166;75;4;0;0;0;0;0;25;37.91;12.82;1888.25;500;-525;7553;30212;33988.5;37765;45318
6;Lanesthesist;990;-750;25000;68300;358;334;298;741;161;79;7;2;0;0;0;0;25.25;36.16;8.93;1750;375;-375;7000;28000;31500;35000;42000
7;Touchdown67.;983;-775;36575;97400;339;291;353;758;143;78;3;0;1;0;0;0;37.21;34.49;11.23;2560.25;375;-400;10241;40964;46084.5;51205;61446
8;adopteunbet;939;-2350;46950;123700;343;309;287;719;150;66;4;0;0;0;0;0;50;36.53;12.18;3286.5;225;-2125;13146;52584;59157;65730;78876
10;Tu_Te_Calm;738;550;20100;53950;271;255;212;561;121;49;5;2;0;0;0;0;27.24;36.72;10.53;1407;225;775;5628;22512;25326;28140;33768
11;jjsam;693;-1675;19125;52650;218;273;202;513;112;64;3;1;0;0;0;0;27.6;31.46;8.24;1338.75;150;-1525;5355;21420;24097.5;26775;32130
13;LordBendtner;540;900;13700;36350;220;206;114;411;92;35;1;1;0;0;0;0;25.37;40.74;11.56;959;150;1050;3836;15344;17262;19180;23016
14;KYFFF;526;1600;13150;35450;210;160;156;392;93;37;4;0;0;0;0;0;25;39.92;10.14;920.5;150;1750;3682;14728;16569;18410;22092
15;U.S.Tuermer.;520;-150;13000;36350;189;195;136;384;79;50;7;0;0;0;0;0;25;36.35;6.79;910;150;0;3640;14560;16380;18200;21840
16;KhaleesiFTW;514;700;12850;35350;196;188;130;392;83;33;5;0;1;0;0;0;25;38.13;8.3;899.5;75;775;3598;14392;16191;17990;21588
17;railegh;487;-1200;15250;40900;179;142;166;367;85;27;8;0;0;0;0;0;31.31;36.76;10.6;1067.5;75;-1125;4270;17080;19215;21350;25620
18;BetterCallMe;483;-1150;20200;51800;176;155;152;384;71;25;3;0;0;0;0;0;41.82;36.44;14.52;1414;75;-1075;5656;22624;25452;28280;33936
19;alinou53;418;-2775;19075;51150;129;145;144;315;67;33;3;0;0;0;0;0;45.63;30.86;10.62;1335.25;75;-2700;5341;21364;24034.5;26705;32046
20;piz55;394;-1825;11575;30700;129;130;135;300;59;30;5;0;0;0;0;0;29.38;32.74;11.59;810.25;75;-1750;3241;12964;14584.5;16205;19446
21;jetelamet13;384;-1000;10900;29000;129;118;137;294;55;31;4;0;0;0;0;0;28.39;33.59;11.31;763;75;-925;3052;12208;13734;15260;18312
25;megapitch;363;-1125;9175;24050;124;138;101;282;56;22;3;0;0;0;0;0;25.28;34.16;12.62;642.25;75;-1050;2569;10276;11560.5;12845;15414
26;Vase Ectomy;354;-950;11050;29850;128;123;103;269;57;24;3;1;0;0;0;0;31.21;36.16;9.95;773.5;50;-900;3094;12376;13923;15470;18564
27;sirsirsir;337;1725;8425;22300;152;78;107;256;57;22;2;0;0;0;0;0;25;45.1;11.77;589.75;50;1775;2359;9436;10615.5;11795;14154
28;MrTs222;334;450;8350;22500;127;113;94;252;54;25;3;0;0;0;0;0;25;38.02;10.18;584.5;50;500;2338;9352;10521;11690;14028
29;gogepok37;325;-1325;8125;21800;109;109;107;243;55;26;1;0;0;0;0;0;25;33.54;10.56;568.75;50;-1275;2275;9100;10237.5;11375;13650
31;lhelicoptere;300;550;7500;20100;121;109;70;227;48;23;2;0;0;0;0;0;25;40.33;10.67;525;50;600;2100;8400;9450;10500;12600
32;abdennourrr;297;-1325;7475;20150;89;121;87;224;51;18;4;0;0;0;0;0;25.17;29.97;10.14;523.25;50;-1275;2093;8372;9418.5;10465;12558
33;windguru14;297;-525;7775;20900;103;88;106;220;54;21;2;0;0;0;0;0;26.18;34.68;10.4;544.25;50;-475;2177;8708;9796.5;10885;13062
34;noa2708;280;-1600;10750;28750;91;99;90;217;40;19;4;0;0;0;0;0;38.39;32.5;10.85;752.5;50;-1550;3010;12040;13545;15050;18060
35;TOILET ABUSE;276;-1650;11550;29750;97;98;81;216;45;14;1;0;0;0;0;0;41.85;35.14;14.14;808.5;50;-1600;3234;12936;14553;16170;19404
37;blo_ody;273;-1200;8400;22500;82;106;85;216;41;14;1;0;1;0;0;0;30.77;30.04;10.71;588;50;-1150;2352;9408;10584;11760;14112
38;AAnus Etroit;270;-25;10125;28450;102;93;75;197;51;18;4;0;0;0;0;0;37.5;37.78;6.34;708.75;50;25;2835;11340;12757.5;14175;17010
39;kikerced;266;-425;6925;18550;96;77;93;200;42;23;1;0;0;0;0;0;26.03;36.09;10.71;484.75;50;-375;1939;7756;8725.5;9695;11634
40;marcTyson91;262;1125;9975;27100;106;75;81;191;46;25;0;0;0;0;0;0;38.07;40.46;9.44;698.25;50;1175;2793;11172;12568.5;13965;16758
41;LE KAMELEON;261;-175;7075;19200;93;95;73;200;36;23;1;1;0;0;0;0;27.11;35.63;9.54;495.25;50;-125;1981;7924;8914.5;9905;11886
43;FHM 2.0;251;375;6275;17250;92;102;57;188;36;25;2;0;0;0;0;0;25;36.65;8.37;439.25;50;425;1757;7028;7906.5;8785;10542
44;capone73000;246;-425;8525;24050;79;78;89;178;46;19;2;1;0;0;0;0;34.65;32.11;5.96;596.75;50;-375;2387;9548;10741.5;11935;14322
46;Julvar2210;242;-2250;9300;25750;74;68;100;185;37;16;3;1;0;0;0;0;38.43;30.58;7.71;651;50;-2200;2604;10416;11718;13020;15624
47;BienTravail;241;1025;6025;16850;102;70;69;179;32;28;2;0;0;0;0;0;25;42.32;6.78;421.75;50;1075;1687;6748;7591.5;8435;10122
49;S i r   J V;231;-575;5775;14600;79;86;66;183;37;10;1;0;0;0;0;0;25;34.2;15.73;404.25;50;-525;1617;6468;7276.5;8085;9702
51;LeBasilicain;218;-100;7400;19400;79;60;79;168;36;13;1;0;0;0;0;0;33.94;36.24;12.61;518;25;-75;2072;8288;9324;10360;12432
52;U_whine_amax;208;-375;5325;14050;69;65;74;153;42;13;0;0;0;0;0;0;25.6;33.17;12.05;372.75;25;-350;1491;5964;6709.5;7455;8946
53;Iscandaar;206;-850;5150;13500;67;73;66;156;36;14;0;0;0;0;0;0;25;32.52;12.62;360.5;25;-825;1442;5768;6489;7210;8652
54;Milanamor27;205;450;6350;15850;87;50;68;164;28;13;0;0;0;0;0;0;30.98;42.44;16.8;444.5;25;475;1778;7112;8001;8890;10668
55;tozmiou13;205;-1225;5575;14200;61;59;85;165;24;16;0;0;0;0;0;0;27.2;29.76;15.1;390.25;25;-1200;1561;6244;7024.5;7805;9366
56;- Viet -;205;275;5125;14600;72;74;59;143;41;19;2;0;0;0;0;0;25;35.12;5.04;358.75;25;300;1435;5740;6457.5;7175;8610
58;Size7;204;-175;5825;15000;71;62;71;160;32;11;1;0;0;0;0;0;28.55;34.8;14.16;407.75;25;-150;1631;6524;7339.5;8155;9786
59;Kehan2212;203;2325;7925;23400;79;48;76;142;41;17;2;1;0;0;0;0;39.04;38.92;1.58;554.75;25;2350;2219;8876;9985.5;11095;13314
60;Naruto29;202;-725;5775;15450;74;69;59;152;31;18;1;0;0;0;0;0;28.59;36.63;10.82;404.25;25;-700;1617;6468;7276.5;8085;9702
61;Cocohen;200;-1000;5000;13050;62;89;49;156;29;14;1;0;0;0;0;0;25;31;13;350;25;-975;1400;5600;6300;7000;8400
62;LesProblems;199;-675;9625;25000;75;53;71;154;34;9;2;0;0;0;0;0;48.37;37.69;13.42;673.75;25;-650;2695;10780;12127.5;13475;16170
63;gaybel;198;525;5075;14150;80;73;45;147;28;22;1;0;0;0;0;0;25.63;40.4;7.06;355.25;25;550;1421;5684;6394.5;7105;8526
64;panny37;197;-1575;5725;14950;59;48;90;149;36;12;0;0;0;0;0;0;29.06;29.95;12.95;400.75;25;-1550;1603;6412;7213.5;8015;9618
65;bishop74270;196;525;5725;15250;79;67;50;147;33;15;1;0;0;0;0;0;29.21;40.31;11.21;400.75;25;550;1603;6412;7213.5;8015;9618
66;grenat57525;195;-25;5175;13900;76;68;51;141;39;15;0;0;0;0;0;0;26.54;38.97;10.47;362.25;25;0;1449;5796;6520.5;7245;8694
67;nkimhoangkie;193;-425;4825;14100;59;71;63;149;23;19;1;0;1;0;0;0;25;30.57;2.59;337.75;25;-400;1351;5404;6079.5;6755;8106
68;AndriusP7;192;-1200;4800;11450;61;85;46;163;21;8;0;0;0;0;0;0;25;31.77;20.49;336;25;-1175;1344;5376;6048;6720;8064
69;FalconX;187;275;5475;15150;75;63;49;132;39;12;4;0;0;0;0;0;29.28;40.11;7.76;383.25;25;300;1533;6132;6898.5;7665;9198
70;leila540;182;50;6050;16650;68;53;61;134;31;16;1;0;0;0;0;0;33.24;37.36;8.26;423.5;25;75;1694;6776;7623;8470;10164
72;Traztaroot57;181;75;4875;12900;72;60;49;134;35;12;0;0;0;0;0;0;26.93;39.78;11.79;341.25;25;100;1365;5460;6142.5;6825;8190
73;Akhym94;180;50;7000;19750;64;62;54;126;40;12;2;0;0;0;0;0;38.89;35.56;5.95;490;25;75;1960;7840;8820;9800;11760
74;Fenix_21;179;-350;5050;13500;65;59;55;139;28;10;2;0;0;0;0;0;28.21;36.31;10.89;353.5;25;-325;1414;5656;6363;7070;8484
75;OhMaWiwi;179;-1300;6300;17500;59;67;53;140;21;14;3;1;0;0;0;0;35.2;32.96;7.41;441;25;-1275;1764;7056;7938;8820;10584
76;fario69;179;675;4725;12750;74;69;36;136;27;15;1;0;0;0;0;0;26.4;41.34;10.05;330.75;25;700;1323;5292;5953.5;6615;7938
78;iaia;174;-575;4725;12650;54;65;55;133;26;14;1;0;0;0;0;0;27.16;31.03;10.76;330.75;25;-550;1323;5292;5953.5;6615;7938
79;Naaddiinne;173;-525;4325;13200;53;64;56;124;36;11;0;1;1;0;0;0;25;30.64;-1.73;302.75;25;-500;1211;4844;5449.5;6055;7266
80;bryan bolt;170;500;5000;14500;61;45;64;125;27;14;3;1;0;0;0;0;29.41;35.88;3.33;350;25;525;1400;5600;6300;7000;8400
81;Renatojunior;167;-100;4800;13500;53;45;69;120;32;14;0;1;0;0;0;0;28.74;31.74;6.25;336;25;-75;1344;5376;6048;6720;8064
82;Negreanuts;167;-825;4475;11350;56;59;52;134;25;8;0;0;0;0;0;0;26.8;33.53;15.46;313.25;25;-800;1253;5012;5638.5;6265;7518
83;HfC_LoVeR;167;225;4175;11300;66;57;44;128;21;17;1;0;0;0;0;0;25;39.52;9.78;292.25;25;250;1169;4676;5260.5;5845;7014
84;Petit doume;167;-375;5375;14250;57;36;74;130;25;12;0;0;0;0;0;0;32.19;34.13;11.63;376.25;25;-350;1505;6020;6772.5;7525;9030
85;Easyrev;167;-500;4550;13250;60;53;54;132;24;9;0;1;1;0;0;0;27.25;35.93;2.93;318.5;25;-475;1274;5096;5733;6370;7644
86;Bimbe;167;225;5575;15050;63;48;56;123;32;11;1;0;0;0;0;0;33.38;37.72;10.01;390.25;25;250;1561;6244;7024.5;7805;9366
87;Tigrouwood1;166;3425;4425;16800;52;64;50;120;34;11;0;0;0;1;0;0;26.66;31.33;-26.55;309.75;25;3450;1239;4956;5575.5;6195;7434
88;LaCestTrop;164;-375;5025;17350;57;51;56;129;27;7;0;0;0;1;0;0;30.64;34.76;-15.09;351.75;25;-350;1407;5628;6331.5;7035;8442
91;le tcho 85;163;275;4675;12150;60;52;51;129;23;10;1;0;0;0;0;0;28.68;36.81;13.37;327.25;25;300;1309;5236;5890.5;6545;7854
92;yves kylian;163;-975;5275;13800;49;56;58;128;23;11;1;0;0;0;0;0;32.36;30.06;12.8;369.25;25;-950;1477;5908;6646.5;7385;8862
93;paschaa0087;160;450;4000;10750;62;48;50;122;30;6;1;1;0;0;0;0;25;38.75;10.42;280;25;475;1120;4480;5040;5600;6720
94;SuperTokard;160;-325;4225;12050;49;46;65;113;27;20;0;0;0;0;0;0;26.41;30.62;4.93;295.75;25;-300;1183;4732;5323.5;5915;7098
95;munegu57;158;875;5125;13650;68;43;47;119;26;13;0;0;0;0;0;0;32.44;43.04;11.22;358.75;25;900;1435;5740;6457.5;7175;8610
96;romainrn;158;875;6475;18150;57;53;48;119;23;13;3;0;0;0;0;0;40.98;36.08;6.56;453.25;25;900;1813;7252;8158.5;9065;10878
97;-mr smith55-;156;-800;3900;10000;46;50;60;122;24;10;0;0;0;0;0;0;25;29.49;14.53;273;25;-775;1092;4368;4914;5460;6552
98;WERZOU;156;-750;5550;14900;54;51;51;116;28;12;0;0;0;0;0;0;35.58;34.62;10.51;388.5;25;-725;1554;6216;6993;7770;9324
99;_CaLviN_;155;400;4050;15800;58;61;36;112;29;13;0;0;0;1;0;0;26.13;37.42;-30.04;283.5;25;425;1134;4536;5103;5670;6804
100;guimlyy;154;-25;6025;16750;46;51;57;114;26;12;2;0;0;0;0;0;39.12;29.87;7.33;421.75;25;0;1687;6748;7591.5;8435;10122
101;MalcatAAnho1;154;400;7300;21100;52;46;56;114;26;11;2;1;0;0;0;0;47.4;33.77;3.65;511;0;400;2044;8176;9198;10220;12264
102;Pgergo11;153;-475;3825;9500;58;57;38;122;25;6;0;0;0;0;0;0;25;37.91;17.21;267.75;0;-475;1071;4284;4819.5;5355;6426
103;IamHaku;151;-425;6975;18500;53;57;41;113;29;8;1;0;0;0;0;0;46.19;35.1;11.59;488.25;0;-425;1953;7812;8788.5;9765;11718
104;Plakeslke;151;-975;7475;19050;52;39;60;119;23;9;0;0;0;0;0;0;49.5;34.44;15.05;523.25;0;-975;2093;8372;9418.5;10465;12558
105;M.G51;150;-100;4250;11700;57;48;45;110;23;16;1;0;0;0;0;0;28.33;38;8.24;297.5;0;-100;1190;4760;5355;5950;7140
106;DiLeonardo;147;1450;7300;20350;69;46;32;111;23;11;1;1;0;0;0;0;49.66;46.94;7.08;511;0;1450;2044;8176;9198;10220;12264
108;MM18;146;-725;5175;14000;51;43;52;105;34;7;0;0;0;0;0;0;35.45;34.93;9.82;362.25;0;-725;1449;5796;6520.5;7245;8694
109;Taubira;145;-650;3650;9200;49;49;47;114;24;7;0;0;0;0;0;0;25.17;33.79;15.98;255.5;0;-650;1022;4088;4599;5110;6132
110;9pressure9;145;425;3675;10400;58;39;48;101;31;12;1;0;0;0;0;0;25.34;40;5.67;257.25;0;425;1029;4116;4630.5;5145;6174
112;alessandro..;144;-700;5300;14300;45;43;56;110;20;13;1;0;0;0;0;0;36.81;31.25;10.06;371;0;-700;1484;5936;6678;7420;8904
113;jayjay34990;144;75;3725;9700;56;42;46;109;27;8;0;0;0;0;0;0;25.87;38.89;13.2;260.75;0;75;1043;4172;4693.5;5215;6258
114;Slime1;143;550;7150;19000;55;36;52;107;27;8;1;0;0;0;0;0;50;38.46;11.42;500.5;0;550;2002;8008;9009;10010;12012
115;milla69;143;-800;3700;9600;43;42;58;109;27;7;0;0;0;0;0;0;25.87;30.07;13.51;259;0;-800;1036;4144;4662;5180;6216
116;Pumking;142;850;3550;9850;63;28;51;113;19;7;1;2;0;0;0;0;25;44.37;7.51;248.5;0;850;994;3976;4473;4970;5964
117;TheoWach;142;-100;4850;13800;46;35;61;103;27;9;2;1;0;0;0;0;34.15;32.39;5.15;339.5;0;-100;1358;5432;6111;6790;8148
118;TOUFIK76;141;-900;4200;11700;44;48;49;101;29;11;0;0;0;0;0;0;29.79;31.21;7.14;294;0;-900;1176;4704;5292;5880;7056
119;lavinia83;141;-675;3525;9250;45;49;47;111;20;8;2;0;0;0;0;0;25;31.91;12.53;246.75;0;-675;987;3948;4441.5;4935;5922
120;Datura91;141;-325;4775;13650;46;46;49;97;31;12;1;0;0;0;0;0;33.87;32.62;4.71;334.25;0;-325;1337;5348;6016.5;6685;8022
121;siddd;141;350;7050;18600;55;36;50;105;27;9;0;0;0;0;0;0;50;39.01;12.06;493.5;0;350;1974;7896;8883;9870;11844
122;ChibreAcier7;139;250;6650;16700;53;57;29;110;21;8;0;0;0;0;0;0;47.84;38.13;16.29;465.5;0;250;1862;7448;8379;9310;11172
123;Emberiza;138;-800;3550;9600;43;49;46;102;24;11;1;0;0;0;0;0;25.72;31.16;9.86;248.5;0;-800;994;3976;4473;4970;5964
124;V1rOgn3;138;-1125;5025;13000;47;54;37;111;20;6;1;0;0;0;0;0;36.41;34.06;13.76;351.75;0;-1125;1407;5628;6331.5;7035;8442
126;sidney04120;138;-250;3550;9300;53;51;34;110;17;9;2;0;0;0;0;0;25.72;38.41;12.68;248.5;0;-250;994;3976;4473;4970;5964
127;hugowinamax;137;25;4425;12800;46;48;43;94;30;10;3;0;0;0;0;0;32.3;33.58;3.58;309.75;0;25;1239;4956;5575.5;6195;7434
128;Jupy973;136;-875;4825;13600;45;45;46;99;24;12;1;0;0;0;0;0;35.48;33.09;6.04;337.75;0;-875;1351;5404;6079.5;6755;8106
129;SylvainB01;135;-225;4225;10500;48;37;50;109;17;9;0;0;0;0;0;0;31.3;35.56;17.16;295.75;0;-225;1183;4732;5323.5;5915;7098
130;freddoc70;135;-1400;4050;10700;37;48;50;102;23;9;1;0;0;0;0;0;30;27.41;11.93;283.5;0;-1400;1134;4536;5103;5670;6804
131;ALaRetraite;134;300;6700;16200;55;27;52;114;12;8;0;0;0;0;0;0;50;41.04;19.4;469;0;300;1876;7504;8442;9380;11256
132;virgie79;134;-125;4575;14600;45;38;51;92;27;10;4;1;0;0;0;0;34.14;33.58;-6.38;320.25;0;-125;1281;5124;5764.5;6405;7686
133;marcaurel79;134;-600;4600;12850;44;56;34;96;27;9;2;0;0;0;0;0;34.33;32.84;6.88;322;0;-600;1288;5152;5796;6440;7728
134;loloche8888;133;-525;3475;9250;40;35;58;99;26;6;2;0;0;0;0;0;26.13;30.08;11.27;243.25;0;-525;973;3892;4378.5;4865;5838
135;drake5;133;-250;3400;8800;53;39;41;107;17;7;2;0;0;0;0;0;25.56;39.85;13.73;238;0;-250;952;3808;4284;4760;5712
136;PAN PAN QQ;133;-25;5625;16250;48;45;40;96;21;14;1;1;0;0;0;0;42.29;36.09;3.7;393.75;0;-25;1575;6300;7087.5;7875;9450
137;1_ticket_plz;133;450;5800;14200;57;37;39;113;11;8;1;0;0;0;0;0;43.61;42.86;18.39;406;0;450;1624;6496;7308;8120;9744
138;zorosky;133;750;3750;10750;58;41;34;97;20;14;1;1;0;0;0;0;28.2;43.61;4.44;262.5;0;750;1050;4200;4725;5250;6300
139;keikogi;132;-175;3575;9000;51;33;48;105;21;5;1;0;0;0;0;0;27.08;38.64;16.08;250.25;0;-175;1001;4004;4504.5;5005;6006
142;mAD le BaRGe;130;-675;3625;9600;41;43;46;98;21;11;0;0;0;0;0;0;27.88;31.54;11.72;253.75;0;-675;1015;4060;4567.5;5075;6090
143;enidron76;130;425;3875;11350;53;33;44;95;25;8;1;1;0;0;0;0;29.81;40.77;2.37;271.25;0;425;1085;4340;4882.5;5425;6510
144;wina-30;128;-25;3425;9050;50;32;46;101;18;8;1;0;0;0;0;0;26.76;39.06;11.92;239.75;0;-25;959;3836;4315.5;4795;5754
145;alicia1204;128;-150;3250;8450;43;40;45;108;7;10;3;0;0;0;0;0;25.39;33.59;13.33;227.5;0;-150;910;3640;4095;4550;5460
146;Gincoca35;128;375;5975;17150;49;37;42;85;32;9;2;0;0;0;0;0;46.68;38.28;4.32;418.25;0;375;1673;6692;7528.5;8365;10038
147;Rest trankil;127;-825;3225;8950;37;46;44;94;21;10;2;0;0;0;0;0;25.39;29.13;7.49;225.75;0;-825;903;3612;4063.5;4515;5418
148;babas8;125;-450;3450;10000;41;46;38;89;25;9;1;1;0;0;0;0;27.6;32.8;3.38;241.5;0;-450;966;3864;4347;4830;5796
149;diaoulruz;125;-275;3675;10050;48;38;39;97;18;8;1;1;0;0;0;0;29.4;38.4;8.84;257.25;0;-275;1029;4116;4630.5;5145;6174
150;Deejaysam;125;-950;3500;9400;32;48;45;98;14;11;2;0;0;0;0;0;28;25.6;10.48;245;0;-950;980;3920;4410;4900;5880
151;padon14;122;-150;3050;7900;42;45;35;95;20;6;1;0;0;0;0;0;25;34.43;13.66;213.5;0;-150;854;3416;3843;4270;5124
152;Super Red;121;-100;3600;9200;44;34;43;93;20;8;0;0;0;0;0;0;29.75;36.36;14.81;252;0;-100;1008;4032;4536;5040;6048
153;TiSoJuTo;121;-775;3275;8450;40;40;41;92;23;5;1;0;0;0;0;0;27.07;33.06;13.99;229.25;0;-775;917;3668;4126.5;4585;5502
154;tank007;121;700;3800;10300;52;31;38;90;17;14;0;0;0;0;0;0;31.4;42.98;9.65;266;0;700;1064;4256;4788;5320;6384
155;delvik;120;925;3275;9650;50;41;29;85;22;11;2;0;0;0;0;0;27.29;41.67;1.78;229.25;0;925;917;3668;4126.5;4585;5502
156;Merci quiiii;119;-400;3000;8050;44;34;41;94;16;8;0;1;0;0;0;0;25.21;36.97;10.56;210;0;-400;840;3360;3780;4200;5040
157;Ba88con;119;400;5900;16400;43;46;30;81;29;9;0;0;0;0;0;0;49.58;36.13;7.34;413;0;400;1652;6608;7434;8260;9912
158;leblond55;119;500;3650;10300;44;28;47;90;19;7;3;0;0;0;0;0;30.67;36.97;5.94;255.5;0;500;1022;4088;4599;5110;6132
159;.FUNNYFISH.;119;425;2975;7550;52;40;27;93;20;6;0;0;0;0;0;0;25;43.7;15.41;208.25;0;425;833;3332;3748.5;4165;4998
160;Raf266;118;1950;4400;11800;55;33;30;89;19;10;0;0;0;0;0;0;37.29;46.61;10.61;308;0;1950;1232;4928;5544;6160;7392
161;Julien4731;118;-750;4900;14750;35;35;48;79;28;10;0;0;1;0;0;0;41.53;29.66;-0.34;343;0;-750;1372;5488;6174;6860;8232
162;jumo57;117;0;3550;9050;46;40;31;90;19;8;0;0;0;0;0;0;30.34;39.32;15.02;248.5;0;0;994;3976;4473;4970;5964
163;Hayspacha;117;-600;3450;9550;38;28;51;89;14;12;2;0;0;0;0;0;29.49;32.48;7.73;241.5;0;-600;966;3864;4347;4830;5796
164;jeny47cool;117;575;3525;9900;46;42;29;84;22;10;1;0;0;0;0;0;30.13;39.32;6.38;246.75;0;575;987;3948;4441.5;4935;5922
165;_SperK_;116;-125;4625;12550;44;39;33;90;20;5;0;1;0;0;0;0;39.87;37.93;9.55;323.75;0;-125;1295;5180;5827.5;6475;7770
166;RiVeRShArK15;116;-50;3550;9200;48;37;31;91;19;4;2;0;0;0;0;0;30.6;41.38;13.62;248.5;0;-50;994;3976;4473;4970;5964
167;Armani78520;115;-300;4250;11850;34;53;28;90;17;5;2;1;0;0;0;0;36.96;29.57;7.06;297.5;0;-300;1190;4760;5355;5950;7140
168;k1fry27;115;425;3275;8850;48;43;24;85;22;6;2;0;0;0;0;0;28.48;41.74;9.92;229.25;0;425;917;3668;4126.5;4585;5502
169;Tootsyyy;114;-875;3125;9050;30;39;45;76;25;13;0;0;0;0;0;0;27.41;26.32;3.47;218.75;0;-875;875;3500;3937.5;4375;5250
170;Jphi84;114;-825;3275;8450;34;46;34;91;15;7;1;0;0;0;0;0;28.73;29.82;13.99;229.25;0;-825;917;3668;4126.5;4585;5502
171;SCOFIELD0413;113;325;3025;8450;46;36;31;86;16;9;1;1;0;0;0;0;26.77;40.71;6.89;211.75;0;325;847;3388;3811.5;4235;5082
173;Wovenhand;112;250;2800;7300;45;33;34;90;10;12;0;0;0;0;0;0;25;40.18;13.1;196;0;250;784;3136;3528;3920;4704
174;pablo8413;112;-400;2900;7800;36;41;35;82;21;9;0;0;0;0;0;0;25.89;32.14;10.34;203;0;-400;812;3248;3654;4060;4872
175;Alesmith;111;-1800;4550;11350;29;50;32;91;13;7;0;0;0;0;0;0;40.99;26.13;16.85;318.5;0;-1800;1274;5096;5733;6370;7644
176;jerome83;111;-325;2775;7300;38;35;38;85;19;6;1;0;0;0;0;0;25;34.23;12.31;194.25;0;-325;777;3108;3496.5;3885;4662
177;Gini2a;111;-550;5550;14800;37;45;29;85;17;8;1;0;0;0;0;0;50;33.33;11.11;388.5;0;-550;1554;6216;6993;7770;9324
178;FeLiNFer-AS;110;-550;3700;9800;38;38;34;84;18;7;1;0;0;0;0;0;33.64;34.55;11.71;259;0;-550;1036;4144;4662;5180;6216
179;PSG1118;109;-100;3950;11800;39;39;31;68;28;11;2;0;0;0;0;0;36.24;35.78;0.42;276.5;0;-100;1106;4424;4977;5530;6636
180;Hello-Kitty1;109;-925;3525;9200;32;39;38;84;16;9;0;0;0;0;0;0;32.34;29.36;13;246.75;0;-925;987;3948;4441.5;4935;5922
181;badbeatland.;109;-1075;4875;12800;34;41;34;81;21;7;0;0;0;0;0;0;44.72;31.19;12.48;341.25;0;-1075;1365;5460;6142.5;6825;8190
182;Shurky;109;-100;3350;7950;42;40;27;91;15;3;0;0;0;0;0;0;30.73;38.53;20.9;234.5;0;-100;938;3752;4221;4690;5628
183;IBO32;108;500;3350;8900;42;28;38;81;19;6;2;0;0;0;0;0;31.02;38.89;11.44;234.5;0;500;938;3752;4221;4690;5628
184;momovalentin;108;200;3050;8750;38;32;38;79;15;12;2;0;0;0;0;0;28.24;35.19;4.37;213.5;0;200;854;3416;3843;4270;5124
185;Sir lewis;108;-500;3300;8850;36;19;53;78;23;6;1;0;0;0;0;0;30.56;33.33;10.61;231;0;-500;924;3696;4158;4620;5544
186;virgil1911;108;25;3275;8950;43;31;34;74;25;9;0;0;0;0;0;0;30.32;39.81;8.91;229.25;0;25;917;3668;4126.5;4585;5502
187;Filoutch69;108;200;2700;7700;43;33;32;82;15;9;1;1;0;0;0;0;25;39.81;4.94;189;0;200;756;3024;3402;3780;4536
188;brams94600;108;-525;3775;11100;32;35;41;76;20;9;3;0;0;0;0;0;34.95;29.63;1.99;264.25;0;-525;1057;4228;4756.5;5285;6342
189;Sucre-River;108;250;2700;7000;46;31;31;87;12;8;1;0;0;0;0;0;25;42.59;13.58;189;0;250;756;3024;3402;3780;4536
190;jess.2014;107;-1300;3850;10150;29;26;52;80;19;8;0;0;0;0;0;0;35.98;27.1;12.12;269.5;0;-1300;1078;4312;4851;5390;6468
191;MATETALEX13;107;425;4675;12300;40;29;38;81;18;7;1;0;0;0;0;0;43.69;37.38;12.3;327.25;0;425;1309;5236;5890.5;6545;7854
192;bibi4638;106;75;2725;8150;35;38;33;74;16;14;2;0;0;0;0;0;25.71;33.02;0.31;190.75;0;75;763;3052;3433.5;3815;4578
193;Inhilikan;105;50;2750;7750;39;33;33;78;17;8;2;0;0;0;0;0;26.19;37.14;6.06;192.5;0;50;770;3080;3465;3850;4620
194;SEB1427;105;50;2650;7750;40;28;37;71;21;12;1;0;0;0;0;0;25.24;38.1;2.52;185.5;0;50;742;2968;3339;3710;4452
195;DELIOUS50;105;1300;3400;9800;48;26;31;77;20;6;2;0;0;0;0;0;32.38;45.71;3.92;238;0;1300;952;3808;4284;4760;5712
196;stephenlala;104;375;4125;11950;41;32;31;78;15;7;4;0;0;0;0;0;39.66;39.42;3.43;288.75;0;375;1155;4620;5197.5;5775;6930
197;Cop-y-33;104;-250;4500;11700;37;35;32;79;19;6;0;0;0;0;0;0;43.27;35.58;13.33;315;0;-250;1260;5040;5670;6300;7560
198;gzoulir;103;-75;4125;10300;39;36;28;84;12;7;0;0;0;0;0;0;40.05;37.86;16.77;288.75;0;-75;1155;4620;5197.5;5775;6930
200;isata;102;-800;3250;8700;28;37;37;79;14;8;1;0;0;0;0;0;31.86;27.45;10.77;227.5;0;-800;910;3640;4095;4550;5460
201;Patrun50;102;-1325;2925;7350;28;42;32;80;17;5;0;0;0;0;0;0;28.68;27.45;16.24;204.75;0;-1325;819;3276;3685.5;4095;4914
202;J adooOOoore;101;-900;4300;11750;32;39;30;77;13;9;2;0;0;0;0;0;42.57;31.68;8.91;301;0;-900;1204;4816;5418;6020;7224
