rank;playerName;expressoNb;profit;totalBuyin;totalJackpot;places1;places2;places3;totalX2;totalX4;totalX6;totalX10;totalX20;totalX50;totalX200;totalX1000;totalX10000;averageBuyin;itmPercent;effectiveRake;totalRake;challengePrize;profitPostChall;miles;milesD3;milesD4;milesD5;milesRedD
1;Hey_Jude;2648;-2900;66200;181800;935;907;806;2023;411;192;19;2;0;1;0;0;25;35.31;8.46;4634;2250;-650;18536;74144;83412;92680;111216
2;BetterCallMe;1733;-7725;62525;165300;576;560;597;1346;252;124;7;4;0;0;0;0;36.08;33.24;11.88;4376.75;1500;-6225;17507;70028;78781.5;87535;105042
3;lkjhgfd1;1560;450;39000;106600;571;531;458;1183;251;109;13;3;1;0;0;0;25;36.6;8.89;2730;1000;1450;10920;43680;49140;54600;65520
4;stasiukaxz11;1492;1550;37300;102100;572;527;393;1120;233;122;16;1;0;0;0;0;25;38.34;8.76;2611;750;2300;10444;41776;46998;52220;62664
5;D3cor;1351;-1200;34050;89950;487;473;391;1031;235;72;12;1;0;0;0;0;25.2;36.05;11.94;2383.5;500;-700;9534;38136;42903;47670;57204
7;MrTs222;1149;1675;28725;77900;444;412;293;863;199;79;7;0;1;0;0;0;25;38.64;9.6;2010.75;375;2050;8043;32172;36193.5;40215;48258
8;Bangaloo;1141;-575;30325;83500;391;389;361;856;181;90;13;0;1;0;0;0;26.58;34.27;8.22;2122.75;225;-350;8491;33964;38209.5;42455;50946
9;adopteunbet;1049;1150;52450;140600;386;358;305;784;187;71;7;0;0;0;0;0;50;36.8;10.65;3671.5;225;1375;14686;58744;66087;73430;88116
10;LordBendtner;929;625;23225;62050;351;335;243;704;150;69;6;0;0;0;0;0;25;37.78;10.94;1625.75;225;850;6503;26012;29263.5;32515;39018
11;Aaanditsgone;927;1275;36525;1e+05;346;307;274;688;151;78;9;1;0;0;0;0;39.4;37.32;8.74;2556.75;150;1425;10227;40908;46021.5;51135;61362
12;U.S.Tuermer.;888;1550;22200;59550;343;355;190;660;169;51;8;0;0;0;0;0;25;38.63;10.59;1554;150;1700;6216;24864;27972;31080;37296
13;gogepok37;667;-375;16675;45450;243;230;194;503;101;58;4;1;0;0;0;0;25;36.43;9.15;1167.25;150;-225;4669;18676;21010.5;23345;28014
14;nounieu;513;150;16250;42150;195;168;150;394;81;35;3;0;0;0;0;0;31.68;38.01;13.54;1137.5;150;300;4550;18200;20475;22750;27300
15;AndriusP7;511;2150;22250;84550;188;196;127;374;98;36;2;0;0;0;1;0;43.54;36.79;-26.67;1557.5;150;2300;6230;24920;28035;31150;37380
16;lhelicoptere;488;-50;12200;32150;184;164;140;373;77;37;1;0;0;0;0;0;25;37.7;12.16;854;75;25;3416;13664;15372;17080;20496
17;BanFromPluto;452;-1600;12600;32600;157;160;135;350;74;26;2;0;0;0;0;0;27.88;34.73;13.76;882;75;-1525;3528;14112;15876;17640;21168
18;windguru14;417;-475;12625;34250;151;125;141;315;70;25;6;1;0;0;0;0;30.28;36.21;9.57;883.75;75;-400;3535;14140;15907.5;17675;21210
19;5massam5;400;-500;13650;36600;144;123;133;307;62;29;2;0;0;0;0;0;34.12;36;10.62;955.5;75;-425;3822;15288;17199;19110;22932
20;AAnus Etroit;380;3225;17475;48700;165;102;113;276;71;28;5;0;0;0;0;0;45.99;43.42;7.11;1223.25;75;3300;4893;19572;22018.5;24465;29358
21;- Viet -;377;-475;9675;27200;132;117;128;272;63;38;4;0;0;0;0;0;25.66;35.01;6.29;677.25;75;-400;2709;10836;12190.5;13545;16254
22;BurjAlArab;359;-2725;11075;30200;101;133;125;266;60;29;3;1;0;0;0;0;30.85;28.13;9.1;775.25;75;-2650;3101;12404;13954.5;15505;18606
23;titouan888;357;-75;15725;42300;126;106;125;266;66;23;2;0;0;0;0;0;44.05;35.29;10.33;1100.75;75;0;4403;17612;19813.5;22015;26418
24;PAN PAN QQ;341;575;15575;40800;132;103;106;269;47;23;0;2;0;0;0;0;45.67;38.71;12.68;1090.25;75;650;4361;17444;19624.5;21805;26166
25;pepsifred;337;-25;9875;26950;126;104;107;256;52;24;5;0;0;0;0;0;29.3;37.39;9.03;691.25;75;50;2765;11060;12442.5;13825;16590
26;8iRoguH;335;950;8600;22650;137;98;100;266;43;23;2;1;0;0;0;0;25.67;40.9;12.21;602;50;1000;2408;9632;10836;12040;14448
29;I-Want-U;331;-2050;16550;42500;117;110;104;261;46;24;0;0;0;0;0;0;50;35.35;14.4;1158.5;50;-2000;4634;18536;20853;23170;27804
31;unasmonfrere;325;-2850;16250;42800;104;133;88;247;55;22;1;0;0;0;0;0;50;32;12.21;1137.5;50;-2800;4550;18200;20475;22750;27300
32;cpasvole;318;-500;8150;22100;109;86;123;234;58;25;1;0;0;0;0;0;25.63;34.28;9.61;570.5;50;-450;2282;9128;10269;11410;13692
34;PacoRayban;309;500;11350;31450;102;100;107;223;58;26;1;1;0;0;0;0;36.73;33.01;7.64;794.5;50;550;3178;12712;14301;15890;19068
35;.FUNNYFISH.;308;150;7700;22300;111;110;87;215;56;33;4;0;0;0;0;0;25;36.04;3.46;539;50;200;2156;8624;9702;10780;12936
36;piz55;306;-1950;8200;21350;89;112;105;238;50;16;1;1;0;0;0;0;26.8;29.08;13.21;574;50;-1900;2296;9184;10332;11480;13776
37;bestmind93;289;425;11075;30050;101;93;95;220;43;23;2;1;0;0;0;0;38.32;34.95;9.56;775.25;50;475;3101;12404;13954.5;15505;18606
38;DesperHate;285;1950;14250;36500;119;92;74;222;48;14;1;0;0;0;0;0;50;41.75;14.62;997.5;50;2000;3990;15960;17955;19950;23940
39;alicia1204;281;200;7300;19750;106;93;82;221;36;20;3;1;0;0;0;0;25.98;37.72;9.82;511;50;250;2044;8176;9198;10220;12264
40;iaia;276;-225;8225;22500;103;92;81;201;55;18;2;0;0;0;0;0;29.8;37.32;8.81;575.75;50;-175;2303;9212;10363.5;11515;13818
41;poker-trips;275;125;6925;19700;89;112;74;193;60;16;6;0;0;0;0;0;25.18;32.36;5.17;484.75;50;175;1939;7756;8725.5;9695;11634
42;Gini2a;275;-525;11825;31600;97;110;68;219;36;18;1;0;1;0;0;0;43;35.27;10.92;827.75;50;-475;3311;13244;14899.5;16555;19866
43;FalconX;271;-650;7600;21200;92;98;81;194;55;20;2;0;0;0;0;0;28.04;33.95;7.02;532;50;-600;2128;8512;9576;10640;12768
44;SAMSHAGIRL;269;-1000;7950;21900;91;87;91;201;46;18;4;0;0;0;0;0;29.55;33.83;8.18;556.5;50;-950;2226;8904;10017;11130;13356
45;rokilamoule;268;-25;7525;21100;92;98;78;200;43;24;0;1;0;0;0;0;28.08;34.33;6.53;526.75;50;25;2107;8428;9481.5;10535;12642
46;gamraissa;267;25;9175;24800;93;87;87;201;39;24;3;0;0;0;0;0;34.36;34.83;9.9;642.25;50;75;2569;10276;11560.5;12845;15414
47;Vi1MetrTaTet;263;-450;9950;26600;92;99;72;198;43;20;2;0;0;0;0;0;37.83;34.98;10.89;696.5;50;-400;2786;11144;12537;13930;16716
49;linololo;259;1275;8025;21550;101;88;70;197;42;17;2;1;0;0;0;0;30.98;39;10.49;561.75;50;1325;2247;8988;10111.5;11235;13482
50;jonyvegas;255;25;6375;16350;104;69;82;198;42;15;0;0;0;0;0;0;25;40.78;14.51;446.25;50;75;1785;7140;8032.5;8925;10710
51;megapitch;252;-1450;10400;29100;80;94;78;183;41;25;3;0;0;0;0;0;41.27;31.75;6.73;728;25;-1425;2912;11648;13104;14560;17472
52;Alesmith;247;1600;8300;22500;106;80;61;185;46;13;2;1;0;0;0;0;33.6;42.91;9.64;581;25;1625;2324;9296;10458;11620;13944
53;capone73000;240;350;8200;20850;89;68;83;189;38;12;1;0;0;0;0;0;34.17;37.08;15.24;574;25;375;2296;9184;10332;11480;13776
54;finette69;233;-275;8475;22100;85;57;91;184;35;12;2;0;0;0;0;0;36.37;36.48;13.08;593.25;25;-250;2373;9492;10678.5;11865;14238
55;kikerced;229;1425;9075;50050;75;79;75;162;47;18;0;1;0;0;1;0;39.63;32.75;-83.84;635.25;25;1450;2541;10164;11434.5;12705;15246
56;ChibreAcier7;226;275;10475;28450;87;73;66;165;43;16;2;0;0;0;0;0;46.35;38.5;9.47;733.25;25;300;2933;11732;13198.5;14665;17598
58;LENNY2610;223;-1125;6175;16300;68;71;84;168;39;16;0;0;0;0;0;0;27.69;30.49;12.01;432.25;25;-1100;1729;6916;7780.5;8645;10374
59;geicha;222;-75;7725;20550;82;56;84;164;40;16;2;0;0;0;0;0;34.8;36.94;11.33;540.75;25;-50;2163;8652;9733.5;10815;12978
60;Apouh;222;0;5650;16000;80;68;74;166;32;19;5;0;0;0;0;0;25.45;36.04;5.6;395.5;25;25;1582;6328;7119;7910;9492
61;_CaLviN_;222;-225;6175;15650;78;86;58;182;23;15;2;0;0;0;0;0;27.82;35.14;15.52;432.25;25;-200;1729;6916;7780.5;8645;10374
62;Ajeossi;219;-675;5475;14300;78;81;60;171;33;13;2;0;0;0;0;0;25;35.62;12.94;383.25;25;-650;1533;6132;6898.5;7665;9198
63;Arthur4King;218;-50;5450;14850;86;84;48;161;39;16;2;0;0;0;0;0;25;39.45;9.17;381.5;25;-25;1526;6104;6867;7630;9156
64;Julvar2210;215;-1650;6800;19050;59;71;85;162;32;19;1;1;0;0;0;0;31.63;27.44;6.62;476;25;-1625;1904;7616;8568;9520;11424
65;Tu_Te_Calm;214;800;9950;28600;82;78;54;157;32;23;1;1;0;0;0;0;46.5;38.32;4.19;696.5;25;825;2786;11144;12537;13930;16716
66;superfish75;210;-200;5950;16350;73;52;85;157;31;22;0;0;0;0;0;0;28.33;34.76;8.4;416.5;25;-175;1666;6664;7497;8330;9996
67;alinou53;210;-1150;5250;14150;63;66;81;157;35;17;1;0;0;0;0;0;25;30;10.16;367.5;25;-1125;1470;5880;6615;7350;8820
68;LeBasilicain;210;-1000;6900;17300;68;60;82;168;30;11;1;0;0;0;0;0;32.86;32.38;16.43;483;25;-975;1932;7728;8694;9660;11592
69;BienTravail;205;375;5125;12950;85;72;48;163;30;12;0;0;0;0;0;0;25;41.46;15.77;358.75;25;400;1435;5740;6457.5;7175;8610
70;WALYANISW;203;-1475;5925;14500;66;62;75;166;29;8;0;0;0;0;0;0;29.19;32.51;18.42;414.75;25;-1450;1659;6636;7465.5;8295;9954
71;l autre face;202;-725;6975;18750;72;57;73;153;33;14;2;0;0;0;0;0;34.53;35.64;10.39;488.25;25;-700;1953;7812;8788.5;9765;11718
72;Bambino4;200;300;5000;13650;75;66;59;142;43;15;0;0;0;0;0;0;25;37.5;9;350;25;325;1400;5600;6300;7000;8400
73;jadenolan;200;800;5000;12000;93;51;56;167;26;7;0;0;0;0;0;0;25;46.5;20;350;25;825;1400;5600;6300;7000;8400
74;coachcaillou;199;25;4975;13350;63;72;64;151;35;12;0;1;0;0;0;0;25;31.66;10.55;348.25;25;50;1393;5572;6268.5;6965;8358
75;livreurdu45;196;250;5950;17150;69;47;80;140;34;19;3;0;0;0;0;0;30.36;35.2;3.92;416.5;25;275;1666;6664;7497;8330;9996
76;bruns1987;195;-2550;7500;20400;46;72;77;147;32;13;3;0;0;0;0;0;38.46;23.59;9.33;525;25;-2525;2100;8400;9450;10500;12600
77;Sebonino;195;-325;6025;16050;69;40;86;146;30;19;0;0;0;0;0;0;30.9;35.38;11.2;421.75;25;-300;1687;6748;7591.5;8435;10122
78;abdennourrr;193;-725;4825;11800;69;63;61;157;29;7;0;0;0;0;0;0;25;35.75;18.48;337.75;25;-700;1351;5404;6079.5;6755;8106
79;O0IIIIII0O;191;-1350;9550;24600;61;68;62;149;29;13;0;0;0;0;0;0;50;31.94;14.14;668.5;25;-1325;2674;10696;12033;13370;16044
80;lo-ran;191;175;6175;18250;59;68;64;146;22;20;1;2;0;0;0;0;32.33;30.89;1.48;432.25;25;200;1729;6916;7780.5;8645;10374
81;Negreanu972;190;-550;5100;13400;68;67;55;148;24;17;1;0;0;0;0;0;26.84;35.79;12.42;357;25;-525;1428;5712;6426;7140;8568
82;Size7;188;-725;4825;13750;60;63;65;132;33;22;1;0;0;0;0;0;25.66;31.91;5.01;337.75;25;-700;1351;5404;6079.5;6755;8106
83;AKENATH;184;100;5650;15550;63;51;70;141;24;17;2;0;0;0;0;0;30.71;34.24;8.26;395.5;25;125;1582;6328;7119;7910;9492
84;dampaf;181;125;7425;21950;61;64;56;123;38;17;3;0;0;0;0;0;41.02;33.7;1.46;519.75;25;150;2079;8316;9355.5;10395;12474
85;mR ArnaK;180;325;4725;13000;69;45;66;129;34;16;1;0;0;0;0;0;26.25;38.33;8.29;330.75;25;350;1323;5292;5953.5;6615;7938
86;Vase Ectomy;179;100;5750;15950;67;58;54;130;34;11;4;0;0;0;0;0;32.12;37.43;7.54;402.5;25;125;1610;6440;7245;8050;9660
87;leldorado;176;525;5575;15450;68;49;59;130;29;16;1;0;0;0;0;0;31.68;38.64;7.62;390.25;25;550;1561;6244;7024.5;7805;9366
88;Jacky511;175;-475;6475;16700;62;69;44;131;31;13;0;0;0;0;0;0;37;35.43;14.03;453.25;25;-450;1813;7252;8158.5;9065;10878
89;Akhym94;174;1750;5650;16800;68;54;52;126;26;21;0;1;0;0;0;0;32.47;39.08;0.88;395.5;25;1775;1582;6328;7119;7910;9492
90;temple42;173;-1325;6075;15950;50;59;64;136;21;16;0;0;0;0;0;0;35.12;28.9;12.48;425.25;25;-1300;1701;6804;7654.5;8505;10206
91;troupineur;170;-575;4275;11850;56;44;70;121;32;17;0;0;0;0;0;0;25.15;32.94;7.6;299.25;25;-550;1197;4788;5386.5;5985;7182
92;Salskine1978;169;75;4675;11850;67;49;53;132;29;8;0;0;0;0;0;0;27.66;39.64;15.51;327.25;25;100;1309;5236;5890.5;6545;7854
93;badbeatland.;168;475;6525;17100;64;49;55;128;29;9;2;0;0;0;0;0;38.84;38.1;12.64;456.75;25;500;1827;7308;8221.5;9135;10962
94;Mauxbydick;168;-525;5475;14200;56;41;71;127;28;13;0;0;0;0;0;0;32.59;33.33;13.55;383.25;25;-500;1533;6132;6898.5;7665;9198
95;ORTI37;168;0;6300;17550;59;57;52;123;27;17;1;0;0;0;0;0;37.5;35.12;7.14;441;25;25;1764;7056;7938;8820;10584
96;jeffou93;168;150;6850;18650;61;57;50;124;30;12;2;0;0;0;0;0;40.77;36.31;9.25;479.5;25;175;1918;7672;8631;9590;11508
97;Patrun50;168;375;5625;15250;55;58;55;127;27;12;1;1;0;0;0;0;33.48;32.74;9.63;393.75;25;400;1575;6300;7087.5;7875;9450
98;jayjay34990;167;-750;5050;13700;60;54;53;126;31;8;1;1;0;0;0;0;30.24;35.93;9.57;353.5;25;-725;1414;5656;6363;7070;8484
99;casaouifou;166;-125;4575;12500;59;50;57;123;28;15;0;0;0;0;0;0;27.56;35.54;8.93;320.25;25;-100;1281;5124;5764.5;6405;7686
100;isolab;166;-325;4925;13150;55;47;64;128;22;16;0;0;0;0;0;0;29.67;33.13;11;344.75;25;-300;1379;5516;6205.5;6895;8274
101;Tinitouns31;166;0;4300;11900;57;42;67;119;35;11;1;0;0;0;0;0;25.9;34.34;7.75;301;0;0;1204;4816;5418;6020;7224
102;HfC_LoVeR;163;-200;4200;11050;57;69;37;126;25;11;1;0;0;0;0;0;25.77;34.97;12.3;294;0;-200;1176;4704;5292;5880;7056
103;freddoc70;162;75;4725;12850;60;51;51;125;27;7;1;2;0;0;0;0;29.17;37.04;9.35;330.75;0;75;1323;5292;5953.5;6615;7938
105;banzai27;160;-625;4675;13950;48;71;41;109;33;16;2;0;0;0;0;0;29.22;30;0.53;327.25;0;-625;1309;5236;5890.5;6545;7854
106;K. Rijvers;160;19700;5400;39500;56;58;46;124;17;16;2;0;0;0;1;0;33.75;35;-143.83;378;0;19700;1512;6048;6804;7560;9072
107;Lapiche;160;50;4000;10350;61;48;51;122;31;6;1;0;0;0;0;0;25;38.12;13.75;280;0;50;1120;4480;5040;5600;6720
108;margouilla77;160;-925;4875;13900;52;48;60;111;33;16;0;0;0;0;0;0;30.47;32.5;4.96;341.25;0;-925;1365;5460;6142.5;6825;8190
109;BadButteur;158;-575;5675;14300;58;52;48;125;25;8;0;0;0;0;0;0;35.92;36.71;16.01;397.25;0;-575;1589;6356;7150.5;7945;9534
110;Fish6259;158;-100;5350;14300;52;57;49;122;24;10;2;0;0;0;0;0;33.86;32.91;10.9;374.5;0;-100;1498;5992;6741;7490;8988
111;jonah83;158;-750;4300;12750;53;55;50;119;26;11;1;0;1;0;0;0;27.22;33.54;1.16;301;0;-750;1204;4816;5418;6020;7224
112;Raf266;157;-350;4850;13250;52;58;47;120;22;14;1;0;0;0;0;0;30.89;33.12;8.93;339.5;0;-350;1358;5432;6111;6790;8148
113;joueurderami;156;-1150;4150;11450;37;61;58;117;24;14;0;1;0;0;0;0;26.6;23.72;8.03;290.5;0;-1150;1162;4648;5229;5810;6972
114;remonthemoon;155;-175;5125;13200;54;58;43;124;15;15;1;0;0;0;0;0;33.06;34.84;14.15;358.75;0;-175;1435;5740;6457.5;7175;8610
115;jetelamet13;155;125;3875;9650;59;40;56;130;16;7;2;0;0;0;0;0;25;38.06;16.99;271.25;0;125;1085;4340;4882.5;5425;6510
116;ALaRetraite;151;750;7350;22300;52;47;52;106;29;11;4;1;0;0;0;0;48.68;34.44;-1.13;514.5;0;750;2058;8232;9261;10290;12348
117;gaybel;150;0;3750;9700;58;49;43;118;22;9;1;0;0;0;0;0;25;38.67;13.78;262.5;0;0;1050;4200;4725;5250;6300
118;AAkrimoKK;150;1100;4600;12450;59;42;49;113;23;13;1;0;0;0;0;0;30.67;39.33;9.78;322;0;1100;1288;5152;5796;6440;7728
119;Easyrev;149;-1100;3800;9950;43;62;44;119;22;6;1;1;0;0;0;0;25.5;28.86;12.72;266;0;-1100;1064;4256;4788;5320;6384
120;POUPON57;148;-400;4050;10150;53;49;46;119;22;5;2;0;0;0;0;0;27.36;35.81;16.46;283.5;0;-400;1134;4536;5103;5670;6804
121;corama;148;-200;3900;10800;53;35;60;113;17;15;3;0;0;0;0;0;26.35;35.81;7.69;273;0;-200;1092;4368;4914;5460;6552
122;Ramen LEBIFF;147;250;4550;12400;57;56;34;109;26;12;0;0;0;0;0;0;30.95;38.78;9.16;318.5;0;250;1274;5096;5733;6370;7644
123;Cocohen;146;-750;3650;9600;47;54;45;114;20;11;1;0;0;0;0;0;25;32.19;12.33;255.5;0;-750;1022;4088;4599;5110;6132
124;guigui6283;146;1750;3850;35000;53;46;47;110;25;10;0;0;0;0;1;0;26.37;36.3;-203.03;269.5;0;1750;1078;4312;4851;5390;6468
125;bluedemon;145;-475;4225;11900;53;50;42;108;28;8;0;1;0;0;0;0;29.14;36.55;6.11;295.75;0;-475;1183;4732;5323.5;5915;7098
126;Julien4731;144;-1025;5475;13900;46;38;60;114;21;9;0;0;0;0;0;0;38.02;31.94;15.37;383.25;0;-1025;1533;6132;6898.5;7665;9198
127;cemoi1306;144;-50;4700;12450;51;43;50;111;22;11;0;0;0;0;0;0;32.64;35.42;11.7;329;0;-50;1316;5264;5922;6580;7896
128;PhiI lvey;142;-900;7100;18700;47;48;47;107;25;10;0;0;0;0;0;0;50;33.1;12.21;497;0;-900;1988;7952;8946;9940;11928
130;xgilles979;142;-275;4175;11650;48;43;51;104;22;15;1;0;0;0;0;0;29.4;33.8;6.99;292.25;0;-275;1169;4676;5260.5;5845;7014
131;Jango-fett;139;-175;3875;10200;55;31;53;108;22;7;2;0;0;0;0;0;27.88;39.57;12.26;271.25;0;-175;1085;4340;4882.5;5425;6510
132;WERZOU;139;250;4550;12450;47;31;61;102;25;11;1;0;0;0;0;0;32.73;33.81;8.79;318.5;0;250;1274;5096;5733;6370;7644
133;SERGIO3110;139;-1075;4075;10350;41;40;58;107;26;6;0;0;0;0;0;0;29.32;29.5;15.34;285.25;0;-1075;1141;4564;5134.5;5705;6846
134;bishop74270;135;125;3375;8850;53;43;39;103;22;10;0;0;0;0;0;0;25;39.26;12.59;236.25;0;125;945;3780;4252.5;4725;5670
135;River choc;135;375;4025;11050;51;29;55;100;20;15;0;0;0;0;0;0;29.81;37.78;8.49;281.75;0;375;1127;4508;5071.5;5635;6762
136;Sharkmike;135;-275;3725;9900;41;53;41;106;17;11;1;0;0;0;0;0;27.59;30.37;11.41;260.75;0;-275;1043;4172;4693.5;5215;6258
137;Mariutz;135;39375;6325;67600;41;38;56;94;29;10;1;0;0;0;1;0;46.85;30.37;-256.26;442.75;0;39375;1771;7084;7969.5;8855;10626
138;payeman63;135;-225;4675;12900;45;45;45;102;20;13;0;0;0;0;0;0;34.63;33.33;8.02;327.25;0;-225;1309;5236;5890.5;6545;7854
139;MaT Lekukela;135;775;3375;9750;57;54;24;106;15;8;5;1;0;0;0;0;25;42.22;3.7;236.25;0;775;945;3780;4252.5;4725;5670
140;tidom97133;134;-2025;5475;13900;35;48;51;108;16;8;2;0;0;0;0;0;40.86;26.12;15.37;383.25;0;-2025;1533;6132;6898.5;7665;9198
142;___Lazy___;133;175;3725;9800;53;43;37;104;18;10;1;0;0;0;0;0;28.01;39.85;12.3;260.75;0;175;1043;4172;4693.5;5215;6258
143;Ninizia87;132;225;3825;10250;48;45;39;100;21;11;0;0;0;0;0;0;28.98;36.36;10.68;267.75;0;225;1071;4284;4819.5;5355;6426
144;Bad9359;132;-1550;6200;17200;39;30;63;105;12;11;4;0;0;0;0;0;46.97;29.55;7.53;434;0;-1550;1736;6944;7812;8680;10416
145;Touchdown67.;131;-1375;5425;14300;36;53;42;103;16;10;2;0;0;0;0;0;41.41;27.48;12.14;379.75;0;-1375;1519;6076;6835.5;7595;9114
146;ace_d_one67;131;-775;4925;13150;38;56;37;102;14;15;0;0;0;0;0;0;37.6;29.01;11;344.75;0;-775;1379;5516;6205.5;6895;8274
147;Cyl67;131;-625;3325;9050;41;53;37;97;22;11;1;0;0;0;0;0;25.38;31.3;9.27;232.75;0;-625;931;3724;4189.5;4655;5586
148;MorX13;131;400;4900;13200;54;36;41;101;19;10;1;0;0;0;0;0;37.4;41.22;10.2;343;0;400;1372;5488;6174;6860;8232
149;Fiaesdorio;131;-975;4575;11500;37;48;46;107;17;7;0;0;0;0;0;0;34.92;28.24;16.21;320.25;0;-975;1281;5124;5764.5;6405;7686
150;hercha69;130;425;5175;14600;50;39;41;93;25;10;2;0;0;0;0;0;39.81;38.46;5.96;362.25;0;425;1449;5796;6520.5;7245;8694
151;nwf74;128;275;4475;11600;49;34;45;102;19;6;1;0;0;0;0;0;34.96;38.28;13.59;313.25;0;275;1253;5012;5638.5;6265;7518
152;filoudu56;128;-1150;3300;8400;32;42;54;105;13;9;1;0;0;0;0;0;25.78;25;15.15;231;0;-1150;924;3696;4158;4620;5544
153;Boudiilmax;127;250;4400;13150;43;36;48;87;26;10;4;0;0;0;0;0;34.65;33.86;0.38;308;0;250;1232;4928;5544;6160;7392
154;grillonade65;127;225;3425;9250;51;32;44;95;19;12;1;0;0;0;0;0;26.97;40.16;9.98;239.75;0;225;959;3836;4315.5;4795;5754
156;Comar_Baxter;126;-525;4025;10400;43;36;47;96;23;6;1;0;0;0;0;0;31.94;34.13;13.87;281.75;0;-525;1127;4508;5071.5;5635;6762
157;paschaa0087;126;150;3150;8050;49;46;31;100;17;9;0;0;0;0;0;0;25;38.89;14.81;220.5;0;150;882;3528;3969;4410;5292
158;El-Nin0;126;-250;3600;9200;47;44;35;96;24;6;0;0;0;0;0;0;28.57;37.3;14.81;252;0;-250;1008;4032;4536;5040;6048
159;alacasart;126;-800;3850;11300;40;49;37;96;17;12;0;0;1;0;0;0;30.56;31.75;2.16;269.5;0;-800;1078;4312;4851;5390;6468
160;mouss68;126;100;3450;8850;47;32;47;99;18;9;0;0;0;0;0;0;27.38;37.3;14.49;241.5;0;100;966;3864;4347;4830;5796
161;leosanty;125;-525;4625;11800;46;44;35;98;16;11;0;0;0;0;0;0;37;36.8;14.95;323.75;0;-525;1295;5180;5827.5;6475;7770
162;eltchatone;125;25;3975;11750;45;38;42;94;18;9;4;0;0;0;0;0;31.8;36;1.47;278.25;0;25;1113;4452;5008.5;5565;6678
163;Flora2046;125;-125;3125;8650;44;34;47;95;19;10;0;1;0;0;0;0;25;35.2;7.73;218.75;0;-125;875;3500;3937.5;4375;5250
164;RaiseMou;125;-250;3300;9350;41;44;40;94;19;11;0;1;0;0;0;0;26.4;32.8;5.56;231;0;-250;924;3696;4158;4620;5544
165;sancho431;124;-100;3100;8000;44;29;51;99;16;8;1;0;0;0;0;0;25;35.48;13.98;217;0;-100;868;3472;3906;4340;5208
166;Mrcarlito;123;450;3400;9500;49;36;38;90;23;9;0;1;0;0;0;0;27.64;39.84;6.86;238;0;450;952;3808;4284;4760;5712
167;elpichado;123;-575;3225;8350;43;48;32;100;12;10;1;0;0;0;0;0;26.22;34.96;13.7;225.75;0;-575;903;3612;4063.5;4515;5418
168;TIREX01;123;-800;3250;8750;37;48;38;97;16;8;2;0;0;0;0;0;26.42;30.08;10.26;227.5;0;-800;910;3640;4095;4550;5460
169;isata;122;-1150;4150;11100;33;54;35;90;20;12;0;0;0;0;0;0;34.02;27.05;10.84;290.5;0;-1150;1162;4648;5229;5810;6972
170;marcaurel79;122;-925;3625;9650;38;51;33;89;24;9;0;0;0;0;0;0;29.71;31.15;11.26;253.75;0;-925;1015;4060;4567.5;5075;6090
171;Klaks;120;-450;3250;8900;43;38;39;92;18;7;3;0;0;0;0;0;27.08;35.83;8.72;227.5;0;-450;910;3640;4095;4550;5460
172;Alex3194;120;-250;3000;8000;39;31;50;89;26;3;2;0;0;0;0;0;25;32.5;11.11;210;0;-250;840;3360;3780;4200;5040
173;RiVeRShArK15;120;600;3000;7950;49;38;33;91;21;7;1;0;0;0;0;0;25;40.83;11.67;210;0;600;840;3360;3780;4200;5040
174;merci 91;117;-600;3150;8550;39;31;47;88;16;13;0;0;0;0;0;0;26.92;33.33;9.52;220.5;0;-600;882;3528;3969;4410;5292
175;jjsam;117;-750;3250;8450;37;45;35;89;20;8;0;0;0;0;0;0;27.78;31.62;13.33;227.5;0;-750;910;3640;4095;4550;5460
177;loco-hijo;116;150;3050;7950;44;37;35;88;21;7;0;0;0;0;0;0;26.29;37.93;13.11;213.5;0;150;854;3416;3843;4270;5124
178;diaoulruz;115;-175;3725;9800;44;37;34;85;18;12;0;0;0;0;0;0;32.39;38.26;12.3;260.75;0;-175;1043;4172;4693.5;5215;6258
179;olivier17810;115;-425;2875;7650;40;37;38;87;20;7;1;0;0;0;0;0;25;34.78;11.3;201.25;0;-425;805;3220;3622.5;4025;4830
181;Princessss42;115;175;4275;12500;44;41;30;75;31;4;5;0;0;0;0;0;37.17;38.26;2.53;299.25;0;175;1197;4788;5386.5;5985;7182
182;GuideAA;114;-500;2850;7100;39;39;36;89;22;3;0;0;0;0;0;0;25;34.21;16.96;199.5;0;-500;798;3192;3591;3990;4788
183;LeCheikh KDO;114;300;5400;13550;47;38;29;92;15;7;0;0;0;0;0;0;47.37;41.23;16.36;378;0;300;1512;6048;6804;7560;9072
184;TiSoJuTo;114;-150;2850;7800;40;36;38;86;16;11;1;0;0;0;0;0;25;35.09;8.77;199.5;0;-150;798;3192;3591;3990;4788
185;Rocs57;113;-175;3225;8800;41;37;35;82;22;8;1;0;0;0;0;0;28.54;36.28;9.04;225.75;0;-175;903;3612;4063.5;4515;5418
186;Labriche83;113;-775;3325;9050;32;35;46;82;25;6;0;0;0;0;0;0;29.42;28.32;9.27;232.75;0;-775;931;3724;4189.5;4655;5586
187;MANCITY1984;112;-550;3400;9250;37;40;35;86;17;6;3;0;0;0;0;0;30.36;33.04;9.31;238;0;-550;952;3808;4284;4760;5712
189;kani06;111;600;3100;8750;49;29;33;81;19;8;3;0;0;0;0;0;27.93;44.14;5.91;217;0;600;868;3472;3906;4340;5208
190;steflush62;110;-975;3375;9750;32;34;44;79;17;11;3;0;0;0;0;0;30.68;29.09;3.7;236.25;0;-975;945;3780;4252.5;4725;5670
191;wtf_3500;110;775;4525;11300;51;30;29;90;13;7;0;0;0;0;0;0;41.14;46.36;16.76;316.75;0;775;1267;5068;5701.5;6335;7602
192;91TITIFULL;109;0;2900;8000;36;40;33;78;23;6;2;0;0;0;0;0;26.61;33.03;8.05;203;0;0;812;3248;3654;4060;4872
193;TN6114A;109;-25;3325;9200;45;28;36;82;17;8;2;0;0;0;0;0;30.5;41.28;7.77;232.75;0;-25;931;3724;4189.5;4655;5586
194;nbamdwir;109;-525;2875;7750;36;40;33;84;19;4;2;0;0;0;0;0;26.38;33.03;10.14;201.25;0;-525;805;3220;3622.5;4025;4830
195;Sr.PaBlo.E;109;325;3975;10600;41;30;38;84;15;8;2;0;0;0;0;0;36.47;37.61;11.11;278.25;0;325;1113;4452;5008.5;5565;6678
196;scotone1;109;-625;5225;13450;38;39;32;83;21;5;0;0;0;0;0;0;47.94;34.86;14.19;365.75;0;-625;1463;5852;6583.5;7315;8778
197;Sharky&Nuts;108;775;2725;9400;35;32;41;79;18;7;1;2;1;0;0;0;25.23;32.41;-14.98;190.75;0;775;763;3052;3433.5;3815;4578
198;winamagik75;108;700;3050;8500;46;31;31;76;22;9;1;0;0;0;0;0;28.24;42.59;7.1;213.5;0;700;854;3416;3843;4270;5124
199;Hello-Kitty1;108;-1325;3975;10300;25;45;38;89;9;7;3;0;0;0;0;0;36.81;23.15;13.63;278.25;0;-1325;1113;4452;5008.5;5565;6678
200;Ketelsen;107;50;5350;13700;44;47;16;83;18;6;0;0;0;0;0;0;50;41.12;14.64;374.5;0;50;1498;5992;6741;7490;8988
201;alessandro..;107;-1075;4025;10450;33;36;38;84;15;8;0;0;0;0;0;0;37.62;30.84;13.46;281.75;0;-1075;1127;4508;5071.5;5635;6762
202;Jeep.fr;107;-450;4000;10900;38;34;35;78;19;9;1;0;0;0;0;0;37.38;35.51;9.17;280;0;-450;1120;4480;5040;5600;6720
203;FireInTheHoL;107;425;3075;8650;38;28;41;78;20;5;4;0;0;0;0;0;28.74;35.51;6.23;215.25;0;425;861;3444;3874.5;4305;5166
204;bab3006;106;-900;3450;8950;28;50;28;85;13;6;2;0;0;0;0;0;32.55;26.42;13.53;241.5;0;-900;966;3864;4347;4830;5796
205;KILLgaranti;106;400;2700;7200;37;23;46;81;18;6;1;0;0;0;0;0;25.47;34.91;11.11;189;0;400;756;3024;3402;3780;4536
206;dalidache666;106;-750;3500;9600;38;39;29;81;13;10;2;0;0;0;0;0;33.02;35.85;8.57;245;0;-750;980;3920;4410;4900;5880
207;YoniL;106;-675;3175;7500;34;29;43;91;10;5;0;0;0;0;0;0;29.95;32.08;21.26;222.25;0;-675;889;3556;4000.5;4445;5334
208;Momm;106;150;2650;7100;45;24;37;79;18;9;0;0;0;0;0;0;25;42.45;10.69;185.5;0;150;742;2968;3339;3710;4452
209;sdegriver;105;50;2700;7200;39;32;34;81;16;6;2;0;0;0;0;0;25.71;37.14;11.11;189;0;50;756;3024;3402;3780;4536
210;7lucky7;105;325;5225;13850;42;30;33;78;20;7;0;0;0;0;0;0;49.76;40;11.64;365.75;0;325;1463;5852;6583.5;7315;8778
211;Nicosinus;104;0;2900;8450;33;31;40;77;17;9;0;1;0;0;0;0;27.88;31.73;2.87;203;0;0;812;3248;3654;4060;4872
212;farfar57;104;-550;2600;6950;34;28;42;79;17;7;1;0;0;0;0;0;25;32.69;10.9;182;0;-550;728;2912;3276;3640;4368
213;U_whine_amax;104;-550;4600;11150;38;23;43;86;16;2;0;0;0;0;0;0;44.23;36.54;19.2;322;0;-550;1288;5152;5796;6440;7728
214;profisher971;103;-75;2675;7650;36;38;29;78;14;8;3;0;0;0;0;0;25.97;34.95;4.67;187.25;0;-75;749;2996;3370.5;3745;4494
215;munegu57;103;675;2575;6550;49;26;28;82;16;4;1;0;0;0;0;0;25;47.57;15.21;180.25;0;675;721;2884;3244.5;3605;4326
216;Oxymus;103;-1050;3200;7850;32;32;39;84;14;5;0;0;0;0;0;0;31.07;31.07;18.23;224;0;-1050;896;3584;4032;4480;5376
217;Hayspacha;103;-325;2725;6750;35;25;43;83;16;3;1;0;0;0;0;0;26.46;33.98;17.43;190.75;0;-325;763;3052;3433.5;3815;4578
218;Mesut94190;103;75;2575;6800;43;36;24;80;15;7;1;0;0;0;0;0;25;41.75;11.97;180.25;0;75;721;2884;3244.5;3605;4326
219;hummels;103;-525;2825;7350;36;47;20;80;16;7;0;0;0;0;0;0;27.43;34.95;13.27;197.75;0;-525;791;3164;3559.5;3955;4746
220;Barbitouf25;102;-275;2825;7900;29;37;36;75;18;7;2;0;0;0;0;0;27.7;28.43;6.78;197.75;0;-275;791;3164;3559.5;3955;4746
221;TOUFIK76;101;-825;3225;10200;23;40;38;67;21;10;3;0;0;0;0;0;31.93;22.77;-5.43;225.75;0;-825;903;3612;4063.5;4515;5418
222;kak47;101;-300;2700;8300;30;22;49;78;13;8;1;0;1;0;0;0;26.73;29.7;-2.47;189;0;-300;756;3024;3402;3780;4536
223;Eden 62;100;-350;2500;7100;32;39;29;69;22;8;1;0;0;0;0;0;25;32;5.33;175;0;-350;700;2800;3150;3500;4200
224;cepatmaran;100;-150;2500;7050;33;34;33;73;22;3;1;1;0;0;0;0;25;33;6;175;0;-150;700;2800;3150;3500;4200
225;KKickUrAAss;100;775;2575;7100;44;34;22;75;12;13;0;0;0;0;0;0;25.75;44;8.09;180.25;0;775;721;2884;3244.5;3605;4326
226;Doudoukilla;100;100;2600;7450;35;42;23;74;13;11;2;0;0;0;0;0;26;35;4.49;182;0;100;728;2912;3276;3640;4368
227;PaKaiKai;100;-400;5000;13500;38;35;27;79;11;8;2;0;0;0;0;0;50;38;10;350;0;-400;1400;5600;6300;7000;8400
228;- QUEMPIC -;100;0;2500;6500;39;41;20;81;10;8;1;0;0;0;0;0;25;39;13.33;175;0;0;700;2800;3150;3500;4200
229;Ichbintapis;100;125;2625;6550;43;38;19;81;14;4;1;0;0;0;0;0;26.25;43;16.83;183.75;0;125;735;2940;3307.5;3675;4410
