rank;playerName;expressoNb;profit;totalBuyin;totalJackpot;places1;places2;places3;totalX2;totalX4;totalX6;totalX10;totalX20;totalX50;totalX200;totalX1000;totalX10000;averageBuyin;itmPercent;effectiveRake;totalRake;challengePrize;profitPostChall;miles;milesD3;milesD4;milesD5;milesRedD
1;ChildCZ;2921;-7025;73025;194750;999;1079;843;2234;490;172;17;8;0;0;0;0;25;34.2;11.1;5111.75;2250;-4775;20447;81788;92011.5;102235;122682
2;MrTs222;2826;-100;70650;188400;1056;1038;732;2148;459;204;12;3;0;0;0;0;25;37.37;11.11;4945.5;1500;1400;19782;79128;89019;98910;118692
3;BetterCallMe;2557;-1925;111375;300850;915;823;819;1963;405;169;14;4;2;0;0;0;43.56;35.78;9.96;7796.25;1000;-925;31185;124740;140332.5;155925;187110
4;oldhandfishh;2192;7525;72125;202750;810;780;602;1686;346;148;8;1;2;1;0;0;32.9;36.95;6.3;5048.75;750;8275;20195;80780;90877.5;100975;121170
5;Hey_Jude;1396;3275;41325;116750;505;468;423;1054;235;96;8;2;0;1;0;0;29.6;36.17;5.83;2892.75;500;3775;11571;46284;52069.5;57855;69426
6;LENNY2610;1056;-5250;41600;129450;326;351;379;803;153;85;10;2;1;2;0;0;39.39;30.87;-3.73;2912;375;-4875;11648;46592;52416;58240;69888
7;audesusenbas;1028;2750;25700;77150;368;388;272;772;164;81;6;2;2;1;0;0;25;35.8;-0.06;1799;375;3125;7196;28784;32382;35980;43176
8;Petonbet;963;225;34675;94750;354;350;259;741;154;55;9;3;1;0;0;0;36.01;36.76;8.92;2427.25;225;450;9709;38836;43690.5;48545;58254
9;PacoRayban;929;-4025;45625;122250;317;309;303;698;159;65;7;0;0;0;0;0;49.11;34.12;10.68;3193.75;225;-3800;12775;51100;57487.5;63875;76650
10;Fishosaurex;908;-2700;29550;78600;303;297;308;691;151;57;8;1;0;0;0;0;32.54;33.37;11.34;2068.5;225;-2475;8274;33096;37233;41370;49644
11;bruns1987;828;-3125;29225;79650;272;235;321;623;131;67;5;2;0;0;0;0;35.3;32.85;9.15;2045.75;150;-2975;8183;32732;36823.5;40915;49098
12;BanFromPluto;828;-1225;26075;73250;292;308;228;638;128;47;12;1;2;0;0;0;31.49;35.27;6.36;1825.25;150;-1075;7301;29204;32854.5;36505;43806
13;shipthatrAce;784;-2100;38800;101700;299;247;238;608;132;38;4;2;0;0;0;0;49.49;38.14;12.63;2716;150;-1950;10864;43456;48888;54320;65184
14;Addict69;724;100;18100;48900;258;249;217;553;122;42;6;0;1;0;0;0;25;35.64;9.94;1267;150;250;5068;20272;22806;25340;30408
15;Anjuna 7;704;2325;34975;94350;267;253;184;531;110;59;4;0;0;0;0;0;49.68;37.93;10.08;2448.25;150;2475;9793;39172;44068.5;48965;58758
16;robob;623;1125;15575;43350;232;232;159;458;118;41;5;0;1;0;0;0;25;37.24;7.22;1090.25;75;1200;4361;17444;19624.5;21805;26166
17;cunbrejnaca;560;550;14200;37850;222;172;166;436;82;36;5;1;0;0;0;0;25.36;39.64;11.15;994;75;625;3976;15904;17892;19880;23856
18;UdonPowa;511;1600;17600;61650;169;124;218;384;91;31;2;1;0;2;0;0;34.44;33.07;-16.76;1232;75;1675;4928;19712;22176;24640;29568
19;SCOFIELD0413;504;1200;12600;33600;202;148;154;382;78;43;1;0;0;0;0;0;25;40.08;11.11;882;75;1275;3528;14112;15876;17640;21168
20;Le Audrius;503;8050;25150;77200;185;169;149;380;86;30;6;0;0;1;0;0;50;36.78;-2.32;1760.5;75;8125;7042;28168;31689;35210;42252
21;Bambino4;494;-1075;14075;38050;176;178;140;371;79;41;3;0;0;0;0;0;28.49;35.63;9.89;985.25;75;-1000;3941;15764;17734.5;19705;23646
22;RagazzaBella;486;-3675;24275;65750;152;137;197;372;76;33;3;2;0;0;0;0;49.95;31.28;9.72;1699.25;75;-3600;6797;27188;30586.5;33985;40782
23;Sandalius;471;750;23550;61600;187;150;134;365;71;33;2;0;0;0;0;0;50;39.7;12.81;1648.5;75;825;6594;26376;29673;32970;39564
24;bobich44;465;-425;13675;35950;171;169;125;372;60;27;5;1;0;0;0;0;29.41;36.77;12.37;957.25;75;-350;3829;15316;17230.5;19145;22974
25;Akhym94;445;-625;17575;50750;146;168;131;330;66;41;6;1;1;0;0;0;39.49;32.81;3.75;1230.25;75;-550;4921;19684;22144.5;24605;29526
26;_Mosquito_;443;2375;14425;41250;157;147;139;329;84;27;2;0;1;0;0;0;32.56;35.44;4.68;1009.75;50;2425;4039;16156;18175.5;20195;24234
27;windguru14;435;600;16400;46250;155;126;154;313;78;38;5;1;0;0;0;0;37.7;35.63;6;1148;50;650;4592;18368;20664;22960;27552
28;Touchdown67.;411;500;13650;36150;157;139;115;314;69;23;5;0;0;0;0;0;33.21;38.2;11.72;955.5;50;550;3822;15288;17199;19110;22932
29;Alsa57;405;-1075;10225;28500;127;105;173;291;80;28;6;0;0;0;0;0;25.25;31.36;7.09;715.75;50;-1025;2863;11452;12883.5;14315;17178
30;PandaPower;398;-1425;12075;32250;128;122;148;304;67;23;4;0;0;0;0;0;30.34;32.16;10.97;845.25;50;-1375;3381;13524;15214.5;16905;20286
31;Sir x Jr;393;-725;11875;30650;148;147;98;297;69;27;0;0;0;0;0;0;30.22;37.66;13.96;831.25;50;-675;3325;13300;14962.5;16625;19950
32;-Elu-;387;75;10875;28850;142;122;123;301;55;28;2;1;0;0;0;0;28.1;36.69;11.57;761.25;50;125;3045;12180;13702.5;15225;18270
33;pablo8413;386;200;10550;28900;138;123;125;289;57;36;3;1;0;0;0;0;27.33;35.75;8.69;738.5;50;250;2954;11816;13293;14770;17724
34;Milan&Ines;383;-1650;12300;32500;121;144;118;300;55;25;3;0;0;0;0;0;32.11;31.59;11.92;861;50;-1600;3444;13776;15498;17220;20664
35;carplaygirl;366;425;13125;34600;132;120;114;286;53;22;4;1;0;0;0;0;35.86;36.07;12.13;918.75;50;475;3675;14700;16537.5;18375;22050
36;Julien4731;365;125;11525;32250;113;109;143;282;57;25;0;0;1;0;0;0;31.58;30.96;6.72;806.75;50;175;3227;12908;14521.5;16135;19362
37;LeBasilicain;363;-3150;13150;34550;114;115;134;284;57;20;1;1;0;0;0;0;36.23;31.4;12.42;920.5;50;-3100;3682;14728;16569;18410;22092
38;alicia1204;362;-875;10675;27900;127;125;110;282;57;21;1;1;0;0;0;0;29.49;35.08;12.88;747.25;50;-825;2989;11956;13450.5;14945;17934
39;O0IIIIII0O;357;-1625;17825;45200;125;132;100;278;64;14;1;0;0;0;0;0;49.93;35.01;15.47;1247.75;50;-1575;4991;19964;22459.5;24955;29946
40;jojolebedo;354;-1275;11575;31850;115;105;134;263;56;33;2;0;0;0;0;0;32.7;32.49;8.28;810.25;50;-1225;3241;12964;14584.5;16205;19446
41;5massam5;345;450;12900;33150;136;89;120;267;57;19;2;0;0;0;0;0;37.39;39.42;14.34;903;50;500;3612;14448;16254;18060;21672
42;Beb0rAx;344;-1700;10850;28150;115;107;122;273;43;26;2;0;0;0;0;0;31.54;33.43;13.52;759.5;50;-1650;3038;12152;13671;15190;18228
43;NaicheZ;344;-525;9625;27300;114;142;88;249;61;30;3;1;0;0;0;0;27.98;33.14;5.45;673.75;50;-475;2695;10780;12127.5;13475;16170
44;CrapsBaz;339;1350;16600;42600;140;108;91;265;53;21;0;0;0;0;0;0;48.97;41.3;14.46;1162;50;1400;4648;18592;20916;23240;27888
45;08NOX10US;332;2875;15275;43500;130;105;97;245;59;26;1;0;1;0;0;0;46.01;39.16;5.07;1069.25;50;2925;4277;17108;19246.5;21385;25662
46;The kingO;330;-900;8800;23450;114;109;107;247;57;23;3;0;0;0;0;0;26.67;34.55;11.17;616;50;-850;2464;9856;11088;12320;14784
47;enjoz;329;-925;8275;23100;110;137;82;241;54;30;4;0;0;0;0;0;25.15;33.43;6.95;579.25;50;-875;2317;9268;10426.5;11585;13902
48;simson82;322;-675;14525;38150;119;113;90;241;65;14;2;0;0;0;0;0;45.11;36.96;12.45;1016.75;50;-625;4067;16268;18301.5;20335;24402
49;TKOMEC;322;1950;10350;28400;140;96;86;239;55;26;1;1;0;0;0;0;32.14;43.48;8.53;724.5;50;2000;2898;11592;13041;14490;17388
50;TOUFIK76;321;-400;11750;30950;117;113;91;247;50;22;2;0;0;0;0;0;36.6;36.45;12.2;822.5;50;-350;3290;13160;14805;16450;19740
51;Javi694;319;-925;7975;21400;110;99;110;241;53;22;3;0;0;0;0;0;25;34.48;10.55;558.25;25;-900;2233;8932;10048.5;11165;13398
52;Fin2carriere;316;1150;7900;22550;116;103;97;236;47;27;4;2;0;0;0;0;25;36.71;4.85;553;25;1175;2212;8848;9954;11060;13272
53;alinou53;315;-3100;14800;39350;98;91;126;251;47;15;1;0;1;0;0;0;46.98;31.11;11.37;1036;25;-3075;4144;16576;18648;20720;24864
54;unasmonfrere;311;-1550;15550;43100;102;109;100;227;52;30;2;0;0;0;0;0;50;32.8;7.61;1088.5;25;-1525;4354;17416;19593;21770;26124
55;Le0nArdA;309;200;11650;30200;118;89;102;249;41;16;2;1;0;0;0;0;37.7;38.19;13.59;815.5;25;225;3262;13048;14679;16310;19572
56;jiv72;297;-775;9275;24350;99;82;116;229;45;20;3;0;0;0;0;0;31.23;33.33;12.49;649.25;25;-750;2597;10388;11686.5;12985;15582
57;Jujumanon42;297;550;7800;23650;116;77;104;220;47;26;3;0;1;0;0;0;26.26;39.06;-1.07;546;25;575;2184;8736;9828;10920;13104
58;30.06.2014;285;-275;7125;18750;95;89;101;219;48;15;3;0;0;0;0;0;25;33.33;12.28;498.75;25;-250;1995;7980;8977.5;9975;11970
59;blo_ody;283;-1200;7450;20600;87;101;95;211;49;21;1;1;0;0;0;0;26.33;30.74;7.83;521.5;25;-1175;2086;8344;9387;10430;12516
60;AdAugusta;280;500;7000;18900;108;102;70;208;46;26;0;0;0;0;0;0;25;38.57;10;490;25;525;1960;7840;8820;9800;11760
61;gaybel;276;-175;8225;21850;107;108;61;211;45;19;1;0;0;0;0;0;29.8;38.77;11.45;575.75;25;-150;2303;9212;10363.5;11515;13818
62;Lilac wine;270;-975;6975;18100;89;86;95;212;42;15;1;0;0;0;0;0;25.83;32.96;13.5;488.25;25;-950;1953;7812;8788.5;9765;11718
63;truzman;267;1300;10600;30150;94;69;104;193;47;22;4;1;0;0;0;0;39.7;35.21;5.19;742;25;1325;2968;11872;13356;14840;17808
64;bzhy38;263;-700;6800;19050;86;88;89;200;45;15;2;0;1;0;0;0;25.86;32.7;6.62;476;25;-675;1904;7616;8568;9520;11424
65;jasty2k;261;575;6525;16850;111;89;61;202;42;17;0;0;0;0;0;0;25;42.53;13.92;456.75;25;600;1827;7308;8221.5;9135;10962
66;MYDJOUL;260;200;8450;22550;95;56;109;198;42;17;3;0;0;0;0;0;32.5;36.54;11.05;591.5;25;225;2366;9464;10647;11830;14196
67;FrifelinZer;259;-825;8225;21200;87;76;96;207;29;22;1;0;0;0;0;0;31.76;33.59;14.08;575.75;25;-800;2303;9212;10363.5;11515;13818
68;Easyrev;256;-75;9375;25450;101;73;82;188;49;17;2;0;0;0;0;0;36.62;39.45;9.51;656.25;25;-50;2625;10500;11812.5;13125;15750
69;CryMeaRiver.;250;-125;7275;21550;79;99;72;165;56;26;2;1;0;0;0;0;29.1;31.6;1.26;509.25;25;-100;2037;8148;9166.5;10185;12222
70;mkaly51;246;-300;6750;18200;89;80;77;186;40;18;1;1;0;0;0;0;27.44;36.18;10.12;472.5;25;-275;1890;7560;8505;9450;11340
71;ljeff;242;-625;6075;17350;81;92;69;171;42;27;2;0;0;0;0;0;25.1;33.47;4.8;425.25;25;-600;1701;6804;7654.5;8505;10206
72;Provencal11;241;1000;6550;17950;97;59;85;177;46;14;4;0;0;0;0;0;27.18;40.25;8.65;458.5;25;1025;1834;7336;8253;9170;11004
73;maklauds;236;-50;9950;25550;90;79;67;183;40;13;0;0;0;0;0;0;42.16;38.14;14.41;696.5;25;-25;2786;11144;12537;13930;16716
74;BadButteur;236;-700;5950;14900;84;76;76;190;35;10;1;0;0;0;0;0;25.21;35.59;16.53;416.5;25;-675;1666;6664;7497;8330;9996
75;ddr3ssd;234;-100;5850;15550;87;75;72;177;44;12;0;1;0;0;0;0;25;37.18;11.4;409.5;25;-75;1638;6552;7371;8190;9828
76;Vincejj;233;-1075;7575;20900;77;88;68;172;44;16;1;0;0;0;0;0;32.51;33.05;8.03;530.25;25;-1050;2121;8484;9544.5;10605;12726
77;gogepok37;233;-475;5825;14800;80;74;79;184;35;14;0;0;0;0;0;0;25;34.33;15.31;407.75;25;-450;1631;6524;7339.5;8155;9786
78;Katk;231;-175;5775;14950;81;79;71;174;46;11;0;0;0;0;0;0;25;35.06;13.71;404.25;25;-150;1617;6468;7276.5;8085;9702
79;shaka83;231;-825;7425;19850;76;72;83;169;45;15;2;0;0;0;0;0;32.14;32.9;10.89;519.75;25;-800;2079;8316;9355.5;10395;12474
80;TopGunJTs;228;-700;9300;24500;85;73;70;173;39;14;2;0;0;0;0;0;40.79;37.28;12.19;651;25;-675;2604;10416;11718;13020;15624
81;solal38;223;300;6900;18000;85;53;85;169;40;14;0;0;0;0;0;0;30.94;38.12;13.04;483;25;325;1932;7728;8694;9660;11592
82;EB2A;221;-475;6525;16400;79;66;76;173;35;13;0;0;0;0;0;0;29.52;35.75;16.22;456.75;25;-450;1827;7308;8221.5;9135;10962
83;lafrappe42;219;-1125;6725;19100;69;68;82;170;23;23;2;0;1;0;0;0;30.71;31.51;5.33;470.75;25;-1100;1883;7532;8473.5;9415;11298
84;malicoptere;218;-275;5775;15600;75;63;80;169;29;17;3;0;0;0;0;0;26.49;34.4;9.96;404.25;25;-250;1617;6468;7276.5;8085;9702
85;billcarson._;217;100;5650;15550;89;52;76;169;33;10;3;2;0;0;0;0;26.04;41.01;8.26;395.5;25;125;1582;6328;7119;7910;9492
86;PokrThreat;214;-700;5350;14200;75;58;81;159;42;12;1;0;0;0;0;0;25;35.05;11.53;374.5;25;-675;1498;5992;6741;7490;8988
87;Jordgz20;214;-175;5575;14500;78;63;73;163;35;16;0;0;0;0;0;0;26.05;36.45;13.3;390.25;25;-150;1561;6244;7024.5;7805;9366
88;bable06;212;-725;7625;21350;65;50;97;155;37;17;3;0;0;0;0;0;35.97;30.66;6.67;533.75;25;-700;2135;8540;9607.5;10675;12810
89;chibredorr;209;2400;10200;28050;85;55;69;160;34;11;3;1;0;0;0;0;48.8;40.67;8.33;714;25;2425;2856;11424;12852;14280;17136
90;Nicosinus;209;-150;7300;20650;74;82;53;152;35;21;0;1;0;0;0;0;34.93;35.41;5.71;511;25;-125;2044;8176;9198;10220;12264
91;paschaa0087;209;-1100;5600;14700;71;84;54;159;39;10;1;0;0;0;0;0;26.79;33.97;12.5;392;25;-1075;1568;6272;7056;7840;9408
92;ScrumMaster;206;50;5450;14750;74;53;79;155;32;18;1;0;0;0;0;0;26.46;35.92;9.79;381.5;25;75;1526;6104;6867;7630;9156
93;jadenolan;205;-625;5125;13500;75;70;60;159;31;13;2;0;0;0;0;0;25;36.59;12.2;358.75;25;-600;1435;5740;6457.5;7175;8610
94;tchacacaboom;204;-150;5100;13600;72;55;77;158;33;11;1;1;0;0;0;0;25;35.29;11.11;357;25;-125;1428;5712;6426;7140;8568
95;Messi 17000;203;-400;8950;25700;58;85;60;157;32;12;0;1;1;0;0;0;44.09;28.57;4.28;626.5;25;-375;2506;10024;11277;12530;15036
96;AnArKine;201;175;5375;14350;77;58;66;159;27;12;2;1;0;0;0;0;26.74;38.31;11.01;376.25;25;200;1505;6020;6772.5;7525;9030
97;shakalaka;201;750;5150;13800;89;57;55;147;39;15;0;0;0;0;0;0;25.62;44.28;10.68;360.5;25;775;1442;5768;6489;7210;8652
98;Rohnino;198;1800;8250;21450;88;55;55;154;34;9;1;0;0;0;0;0;41.67;44.44;13.33;577.5;25;1825;2310;9240;10395;11550;13860
99;EpicKind;198;-100;4950;13850;71;73;54;154;29;10;3;2;0;0;0;0;25;35.86;6.73;346.5;25;-75;1386;5544;6237;6930;8316
100;KhaleesiFTW;198;-400;9900;36000;63;85;50;146;41;9;1;0;0;1;0;0;50;31.82;-21.21;693;25;-375;2772;11088;12474;13860;16632
101;TiSoJuTo;197;75;5075;13350;75;71;51;146;38;13;0;0;0;0;0;0;25.76;38.07;12.32;355.25;0;75;1421;5684;6394.5;7105;8526
102;mans69;196;-800;6450;16800;70;45;81;147;34;14;1;0;0;0;0;0;32.91;35.71;13.18;451.5;0;-800;1806;7224;8127;9030;10836
103;DesperHate;195;1550;9750;24600;85;56;54;152;35;8;0;0;0;0;0;0;50;43.59;15.9;682.5;0;1550;2730;10920;12285;13650;16380
104;blamafialao;193;-550;5750;14700;71;57;65;150;32;9;2;0;0;0;0;0;29.79;36.79;14.78;402.5;0;-550;1610;6440;7245;8050;9660
105;AAnus Etroit;192;-1275;7375;18650;66;76;50;148;33;11;0;0;0;0;0;0;38.41;34.38;15.71;516.25;0;-1275;2065;8260;9292.5;10325;12390
106;vanou9444;192;-550;5150;13350;67;60;65;149;29;13;1;0;0;0;0;0;26.82;34.9;13.59;360.5;0;-550;1442;5768;6489;7210;8652
107;8Belle8;191;-750;9550;23900;71;69;51;155;26;9;1;0;0;0;0;0;50;37.17;16.58;668.5;0;-750;2674;10696;12033;13370;16044
108;Thrillerium;191;-225;6175;16300;71;66;54;142;34;15;0;0;0;0;0;0;32.33;37.17;12.01;432.25;0;-225;1729;6916;7780.5;8645;10374
109;riverkid3084;190;-725;4825;13600;53;74;63;144;28;13;4;1;0;0;0;0;25.39;27.89;6.04;337.75;0;-725;1351;5404;6079.5;6755;8106
110;TIREX01;190;-1150;4750;11400;62;65;63;160;24;5;1;0;0;0;0;0;25;32.63;20;332.5;0;-1150;1330;5320;5985;6650;7980
111;HustlaStylez;188;225;8675;24300;72;59;57;134;42;10;1;1;0;0;0;0;46.14;38.3;6.63;607.25;0;225;2429;9716;10930.5;12145;14574
112;WERZOU;187;-1650;7550;19000;62;44;81;144;35;8;0;0;0;0;0;0;40.37;33.16;16.11;528.5;0;-1650;2114;8456;9513;10570;12684
113;Sebaw;185;-225;6825;18550;72;54;59;140;27;17;0;1;0;0;0;0;36.89;38.92;9.4;477.75;0;-225;1911;7644;8599.5;9555;11466
114;cxin19871026;184;-850;4700;12300;66;60;58;143;28;11;2;0;0;0;0;0;25.54;35.87;12.77;329;0;-850;1316;5264;5922;6580;7896
115;DansTonASS-;183;750;5900;18450;81;43;59;134;35;11;0;2;1;0;0;0;32.24;44.26;-4.24;413;0;750;1652;6608;7434;8260;9912
116;HanK_HulaY;183;-275;4675;13050;63;59;61;135;33;14;0;1;0;0;0;0;25.55;34.43;6.95;327.25;0;-275;1309;5236;5890.5;6545;7854
117;malbar9.7.4;182;25;5925;18100;63;53;66;127;34;18;2;1;0;0;0;0;32.55;34.62;-1.83;414.75;0;25;1659;6636;7465.5;8295;9954
118;fanycanou;180;-1350;4850;12950;58;54;68;136;28;14;2;0;0;0;0;0;26.94;32.22;11;339.5;0;-1350;1358;5432;6111;6790;8148
119;MacMalouff;179;-1250;4650;12450;53;81;45;132;33;14;0;0;0;0;0;0;25.98;29.61;10.75;325.5;0;-1250;1302;5208;5859;6510;7812
120;Volatar2k16;179;-1800;6250;16800;46;80;53;137;22;20;0;0;0;0;0;0;34.92;25.7;10.4;437.5;0;-1800;1750;7000;7875;8750;10500
121;KroKo_Deal;177;-1025;5975;15450;56;69;52;131;38;8;0;0;0;0;0;0;33.76;31.64;13.81;418.25;0;-1025;1673;6692;7528.5;8365;10038
122;FRANINI.13;176;-525;5625;15000;59;46;71;125;43;8;0;0;0;0;0;0;31.96;33.52;11.11;393.75;0;-525;1575;6300;7087.5;7875;9450
123;kikerced;174;-675;4425;11600;55;70;49;133;31;8;2;0;0;0;0;0;25.43;31.61;12.62;309.75;0;-675;1239;4956;5575.5;6195;7434
124;PAN PAN QQ;174;-1000;6850;17750;62;64;48;132;31;11;0;0;0;0;0;0;39.37;35.63;13.63;479.5;0;-1000;1918;7672;8631;9590;11508
125;virgie79;173;-825;5775;14750;59;53;61;135;31;7;0;0;0;0;0;0;33.38;34.1;14.86;404.25;0;-825;1617;6468;7276.5;8085;9702
126;MapyPorrins;172;400;8600;22600;69;65;38;131;28;13;0;0;0;0;0;0;50;40.12;12.4;602;0;400;2408;9632;10836;12040;14448
127;AMERICA-POKE;171;-50;5150;13500;60;41;70;133;23;13;2;0;0;0;0;0;30.12;35.09;12.62;360.5;0;-50;1442;5768;6489;7210;8652
128;lamachine62;170;-450;4600;11700;59;56;55;135;23;12;0;0;0;0;0;0;27.06;34.71;15.22;322;0;-450;1288;5152;5796;6440;7728
129;kiki21000;168;-100;4200;10700;66;62;40;132;26;10;0;0;0;0;0;0;25;39.29;15.08;294;0;-100;1176;4704;5292;5880;7056
130;Arthur4King;168;-200;4200;11450;62;53;53;124;31;11;2;0;0;0;0;0;25;36.9;9.13;294;0;-200;1176;4704;5292;5880;7056
131;madmax441188;167;475;4225;11400;68;41;58;127;25;13;2;0;0;0;0;0;25.3;40.72;10.06;295.75;0;475;1183;4732;5323.5;5915;7098
132;PimPamPoum__;167;-425;8325;21450;63;53;51;132;28;4;3;0;0;0;0;0;49.85;37.72;14.11;582.75;0;-425;2331;9324;10489.5;11655;13986
133;Lamigraine69;167;-1225;5525;15300;50;69;48;123;26;17;1;0;0;0;0;0;33.08;29.94;7.69;386.75;0;-1225;1547;6188;6961.5;7735;9282
134;winamagik75;166;-425;4225;10850;58;62;46;130;26;10;0;0;0;0;0;0;25.45;34.94;14.4;295.75;0;-425;1183;4732;5323.5;5915;7098
135;Joke Air;165;725;4525;12850;63;53;49;124;23;15;2;1;0;0;0;0;27.42;38.18;5.34;316.75;0;725;1267;5068;5701.5;6335;7602
136;castorseb;165;800;7350;19450;70;50;45;126;26;12;1;0;0;0;0;0;44.55;42.42;11.79;514.5;0;800;2058;8232;9261;10290;12348
137;Vi1MetrTaTet;165;375;4375;11500;68;54;43;123;34;7;1;0;0;0;0;0;26.52;41.21;12.38;306.25;0;375;1225;4900;5512.5;6125;7350
138;Blind_fold;164;325;6475;19000;62;55;47;115;35;13;0;0;1;0;0;0;39.48;37.8;2.19;453.25;0;325;1813;7252;8158.5;9065;10878
139;louane1402;164;-100;4100;11250;57;39;68;123;25;14;2;0;0;0;0;0;25;34.76;8.54;287;0;-100;1148;4592;5166;5740;6888
140;xamarol;163;-450;4900;13350;58;53;52;126;24;10;3;0;0;0;0;0;30.06;35.58;9.18;343;0;-450;1372;5488;6174;6860;8232
141;FISH&CHEAP7;162;-400;4450;12450;52;48;62;121;27;11;2;1;0;0;0;0;27.47;32.1;6.74;311.5;0;-400;1246;4984;5607;6230;7476
142;freddoc70;161;-350;4500;12900;59;50;52;122;29;9;0;0;1;0;0;0;27.95;36.65;4.44;315;0;-350;1260;5040;5670;6300;7560
143;ti-breton;161;-2650;7850;21050;46;61;54;121;28;11;1;0;0;0;0;0;48.76;28.57;10.62;549.5;0;-2650;2198;8792;9891;10990;13188
144;FSLT83;160;-950;5200;14050;48;48;64;119;26;15;0;0;0;0;0;0;32.5;30;9.94;364;0;-950;1456;5824;6552;7280;8736
145;fafou1981;160;3225;5275;19200;53;48;59;119;27;12;1;0;0;1;0;0;32.97;33.12;-21.33;369.25;0;3225;1477;5908;6646.5;7385;8862
146;PPhenoMNexuS;159;-1200;5700;16250;44;53;62;121;22;11;4;1;0;0;0;0;35.85;27.67;4.97;399;0;-1200;1596;6384;7182;7980;9576
147;xDEAD-MONEY2;159;-150;4350;11750;58;32;69;120;28;9;1;1;0;0;0;0;27.36;36.48;9.96;304.5;0;-150;1218;4872;5481;6090;7308
148;isa127;159;-25;4275;11650;57;50;52;121;28;9;0;1;0;0;0;0;26.89;35.85;9.16;299.25;0;-25;1197;4788;5386.5;5985;7182
149;Qnel;159;-250;4650;11900;57;50;52;123;25;11;0;0;0;0;0;0;29.25;35.85;14.7;325.5;0;-250;1302;5208;5859;6510;7812
150;impossibile;159;-300;4550;11850;60;51;48;121;25;12;1;0;0;0;0;0;28.62;37.74;13.19;318.5;0;-300;1274;5096;5733;6370;7644
151;Tinitouns31;158;-575;4025;10400;55;51;52;123;23;12;0;0;0;0;0;0;25.47;34.81;13.87;281.75;0;-575;1127;4508;5071.5;5635;6762
152;Size7;158;-100;7500;19900;57;49;52;116;30;12;0;0;0;0;0;0;47.47;36.08;11.56;525;0;-100;2100;8400;9450;10500;12600
153;HateMouselin;158;750;3950;12350;53;47;58;113;25;13;5;2;0;0;0;0;25;33.54;-4.22;276.5;0;750;1106;4424;4977;5530;6636
154;perleine;157;-1300;4200;11600;45;62;50;112;31;13;1;0;0;0;0;0;26.75;28.66;7.94;294;0;-1300;1176;4704;5292;5880;7056
156;tutankhamun;155;-375;3875;10200;51;66;38;116;29;10;0;0;0;0;0;0;25;32.9;12.26;271.25;0;-375;1085;4340;4882.5;5425;6510
157;fab8888;153;-275;3825;9800;52;51;50;123;21;7;2;0;0;0;0;0;25;33.99;14.6;267.75;0;-275;1071;4284;4819.5;5355;6426
158;vivelafete;153;-600;4400;10950;54;48;51;124;21;7;1;0;0;0;0;0;28.76;35.29;17.05;308;0;-600;1232;4928;5544;6160;7392
159;Nonol1512;153;1300;4200;11700;62;60;31;121;24;7;0;0;1;0;0;0;27.45;40.52;7.14;294;0;1300;1176;4704;5292;5880;7056
160;benj59570;152;-75;6575;17650;54;51;47;114;24;13;0;1;0;0;0;0;43.26;35.53;10.52;460.25;0;-75;1841;7364;8284.5;9205;11046
161;loloche8888;152;-400;3800;9950;52;36;64;114;31;6;1;0;0;0;0;0;25;34.21;12.72;266;0;-400;1064;4256;4788;5320;6384
162;Petrozorus;151;350;4650;12800;62;29;60;113;21;17;0;0;0;0;0;0;30.79;41.06;8.24;325.5;0;350;1302;5208;5859;6510;7812
163;-rep-;150;-75;3825;9950;57;46;47;117;23;9;1;0;0;0;0;0;25.5;38;13.29;267.75;0;-75;1071;4284;4819.5;5355;6426
164;MerguezValue;149;-300;4500;11950;54;51;44;114;22;13;0;0;0;0;0;0;30.2;36.24;11.48;315;0;-300;1260;5040;5670;6300;7560
165;XxpoloxX;149;-2225;6875;17650;45;57;47;119;25;4;0;1;0;0;0;0;46.14;30.2;14.42;481.25;0;-2225;1925;7700;8662.5;9625;11550
166;xx_AMSTAF_xx;147;-175;3875;11200;52;43;52;104;27;13;3;0;0;0;0;0;26.36;35.37;3.66;271.25;0;-175;1085;4340;4882.5;5425;6510
167;BDEDO;147;100;4100;11250;52;50;45;106;28;11;2;0;0;0;0;0;27.89;35.37;8.54;287;0;100;1148;4592;5166;5740;6888
168;Jeanlo44;146;850;4350;13450;52;44;50;107;19;16;1;3;0;0;0;0;29.79;35.62;-3.07;304.5;0;850;1218;4872;5481;6090;7308
169;Zabuzakun313;146;-1275;4475;10450;47;52;47;123;20;3;0;0;0;0;0;0;30.65;32.19;22.16;313.25;0;-1275;1253;5012;5638.5;6265;7518
170;Minamax87;146;375;3725;9350;59;39;48;116;23;7;0;0;0;0;0;0;25.51;40.41;16.33;260.75;0;375;1043;4172;4693.5;5215;6258
171;Capa7;145;-425;3975;10650;48;58;39;110;21;13;1;0;0;0;0;0;27.41;33.1;10.69;278.25;0;-425;1113;4452;5008.5;5565;6678
172;Shurky;144;-1200;4450;12300;40;59;45;110;18;14;2;0;0;0;0;0;30.9;27.78;7.87;311.5;0;-1200;1246;4984;5607;6230;7476
173;stakaws;144;325;3875;11050;48;61;35;104;27;11;1;1;0;0;0;0;26.91;33.33;4.95;271.25;0;325;1085;4340;4882.5;5425;6510
174;Pelele64;144;-625;4575;13050;46;56;42;105;23;14;2;0;0;0;0;0;31.77;31.94;4.92;320.25;0;-625;1281;5124;5764.5;6405;7686
175;mopsiszz23;144;500;3600;9750;62;42;40;101;37;5;1;0;0;0;0;0;25;43.06;9.72;252;0;500;1008;4032;4536;5040;6048
176;titcho13;143;475;5675;17550;54;64;25;108;23;9;2;0;1;0;0;0;39.69;37.76;-3.08;397.25;0;475;1589;6356;7150.5;7945;9534
177;PouRiToSs67;142;625;4975;14450;46;45;51;108;16;17;0;1;0;0;0;0;35.04;32.39;3.18;348.25;0;625;1393;5572;6268.5;6965;8358
178;BienTravail;142;1000;3550;9550;66;45;31;100;35;7;0;0;0;0;0;0;25;46.48;10.33;248.5;0;1000;994;3976;4473;4970;5964
179;isolab;142;-825;5275;12800;50;50;42;118;18;6;0;0;0;0;0;0;37.15;35.21;19.12;369.25;0;-825;1477;5908;6646.5;7385;8862
180;CED02200;141;-725;3575;8650;48;42;51;117;19;5;0;0;0;0;0;0;25.35;34.04;19.35;250.25;0;-725;1001;4004;4504.5;5005;6006
181;PUISSANCE 21;141;-750;4000;10200;48;47;46;108;24;9;0;0;0;0;0;0;28.37;34.04;15;280;0;-750;1120;4480;5040;5600;6720
182;moringoo;140;125;4925;12750;58;41;41;108;24;8;0;0;0;0;0;0;35.18;41.43;13.71;344.75;0;125;1379;5516;6205.5;6895;8274
183;Neiles;140;0;3600;10100;47;41;52;101;24;13;2;0;0;0;0;0;25.71;33.57;6.48;252;0;0;1008;4032;4536;5040;6048
184;bebert1215;139;625;3525;9600;60;35;44;102;26;10;1;0;0;0;0;0;25.36;43.17;9.22;246.75;0;625;987;3948;4441.5;4935;5922
185;IWantSuckout;139;-775;3475;9150;44;59;36;105;24;10;0;0;0;0;0;0;25;31.65;12.23;243.25;0;-775;973;3892;4378.5;4865;5838
186;TIAGO2205;137;-300;3950;10150;42;52;43;111;18;7;0;1;0;0;0;0;28.83;30.66;14.35;276.5;0;-300;1106;4424;4977;5530;6636
187;jtetank;137;450;4600;13550;40;46;51;97;30;8;1;1;0;0;0;0;33.58;29.2;1.81;322;0;450;1288;5152;5796;6440;7728
188;z4zou;137;150;3450;9050;53;38;46;104;25;7;1;0;0;0;0;0;25.18;38.69;12.56;241.5;0;150;966;3864;4347;4830;5796
189;panditueur;137;625;3425;14700;46;35;56;98;22;14;2;0;0;1;0;0;25;33.58;-43.07;239.75;0;625;959;3836;4315.5;4795;5754
190;91-MR;137;475;3675;11350;49;52;36;99;20;14;2;2;0;0;0;0;26.82;35.77;-2.95;257.25;0;475;1029;4116;4630.5;5145;6174
191;lucass91;135;375;4225;11300;50;44;41;103;23;8;1;0;0;0;0;0;31.3;37.04;10.85;295.75;0;375;1183;4732;5323.5;5915;7098
192;Sir Pkr;134;200;3650;10150;49;38;47;98;26;8;2;0;0;0;0;0;27.24;36.57;7.31;255.5;0;200;1022;4088;4599;5110;6132
193;12B1-Bill;134;-475;3675;9250;47;37;50;103;27;4;0;0;0;0;0;0;27.43;35.07;16.1;257.25;0;-475;1029;4116;4630.5;5145;6174
194;Zazaeva;134;25;4625;12000;49;31;54;106;15;13;0;0;0;0;0;0;34.51;36.57;13.51;323.75;0;25;1295;5180;5827.5;6475;7770
195;Tomme tueur;133;75;6625;17950;51;31;51;104;13;15;1;0;0;0;0;0;49.81;38.35;9.69;463.75;0;75;1855;7420;8347.5;9275;11130
196;Jajajahomaha;133;-625;4875;12750;48;46;39;103;21;7;2;0;0;0;0;0;36.65;36.09;12.82;341.25;0;-625;1365;5460;6142.5;6825;8190
197;Cleman09;132;-850;3300;8150;41;46;45;109;15;8;0;0;0;0;0;0;25;31.06;17.68;231;0;-850;924;3696;4158;4620;5544
198;MumfieBoy;132;-575;3325;8450;43;43;46;103;22;7;0;0;0;0;0;0;25.19;32.58;15.29;232.75;0;-575;931;3724;4189.5;4655;5586
199;forzaom84;132;-550;3750;9600;44;52;36;104;19;8;1;0;0;0;0;0;28.41;33.33;14.67;262.5;0;-550;1050;4200;4725;5250;6300
200;CoCo Nut;132;425;4075;11100;50;38;44;100;23;6;3;0;0;0;0;0;30.87;37.88;9.2;285.25;0;425;1141;4564;5134.5;5705;6846
201;PhiI lvey;131;175;4975;13500;55;43;33;97;21;13;0;0;0;0;0;0;37.98;41.98;9.55;348.25;0;175;1393;5572;6268.5;6965;8358
202;elrolls;131;-925;4625;11400;45;46;40;109;15;6;1;0;0;0;0;0;35.31;34.35;17.84;323.75;0;-925;1295;5180;5827.5;6475;7770
203;fivekiller;131;50;6150;15350;49;37;45;105;20;6;0;0;0;0;0;0;46.95;37.4;16.8;430.5;0;50;1722;6888;7749;8610;10332
204;KisSMarilynM;131;300;3450;9150;50;43;38;104;17;9;0;1;0;0;0;0;26.34;38.17;11.59;241.5;0;300;966;3864;4347;4830;5796
205;XENANAS;130;275;6275;15450;54;35;41;107;16;7;0;0;0;0;0;0;48.27;41.54;17.93;439.25;0;275;1757;7028;7906.5;8785;10542
206;boudj60;129;450;3900;11950;48;35;46;92;22;11;4;0;0;0;0;0;30.23;37.21;-2.14;273;0;450;1092;4368;4914;5460;6552
207;peppouze alg;129;-575;3725;11050;43;34;52;87;26;13;3;0;0;0;0;0;28.88;33.33;1.12;260.75;0;-575;1043;4172;4693.5;5215;6258
208;OCB72;129;-300;3850;10700;47;27;55;96;21;10;2;0;0;0;0;0;29.84;36.43;7.36;269.5;0;-300;1078;4312;4851;5390;6468
209;SOUS RIRE;128;-875;3875;11100;32;35;61;93;23;9;2;1;0;0;0;0;30.27;25;4.52;271.25;0;-875;1085;4340;4882.5;5425;6510
210;Laeti-jp2012;128;-650;4000;10500;40;48;40;97;22;8;1;0;0;0;0;0;31.25;31.25;12.5;280;0;-650;1120;4480;5040;5600;6720
211;Chris.7777;127;-175;3175;8400;47;39;41;95;23;9;0;0;0;0;0;0;25;37.01;11.81;222.25;0;-175;889;3556;4000.5;4445;5334
212;Briand19;126;-325;3325;14050;38;42;46;93;20;11;1;0;0;1;0;0;26.39;30.16;-40.85;232.75;0;-325;931;3724;4189.5;4655;5586
213;Sedanais5131;126;-525;4625;10750;49;44;33;109;12;5;0;0;0;0;0;0;36.71;38.89;22.52;323.75;0;-525;1295;5180;5827.5;6475;7770
214;litidjas;125;-250;3450;8950;46;32;47;100;18;7;0;0;0;0;0;0;27.6;36.8;13.53;241.5;0;-250;966;3864;4347;4830;5796
215;Gpellat;125;-925;4425;11400;40;38;47;101;16;7;1;0;0;0;0;0;35.4;32;14.12;309.75;0;-925;1239;4956;5575.5;6195;7434
216;kitkekoute;125;-275;3125;8200;45;43;37;94;23;8;0;0;0;0;0;0;25;36;12.53;218.75;0;-275;875;3500;3937.5;4375;5250
217;MorX13;125;875;4825;13750;41;41;43;95;17;11;1;1;0;0;0;0;38.6;32.8;5.01;337.75;0;875;1351;5404;6079.5;6755;8106
218;Hothanh;125;-100;3750;9900;41;29;55;94;23;7;1;0;0;0;0;0;30;32.8;12;262.5;0;-100;1050;4200;4725;5250;6300
219;Koreskalp;125;375;3125;8150;50;43;32;93;26;6;0;0;0;0;0;0;25;40;13.07;218.75;0;375;875;3500;3937.5;4375;5250
220;CR7reaal;124;1000;3250;8750;54;27;43;95;22;4;3;0;0;0;0;0;26.21;43.55;10.26;227.5;0;1000;910;3640;4095;4550;5460
221;lizarazu80;124;-50;3350;9500;46;36;42;86;26;11;1;0;0;0;0;0;27.02;37.1;5.47;234.5;0;-50;938;3752;4221;4690;5628
222;CichyGrzmot;123;-125;3075;8100;49;44;30;96;15;12;0;0;0;0;0;0;25;39.84;12.2;215.25;0;-125;861;3444;3874.5;4305;5166
223;AMSTEPH;122;125;3075;8050;48;45;29;99;15;7;0;1;0;0;0;0;25.2;39.34;12.74;215.25;0;125;861;3444;3874.5;4305;5166
224;vicesmoriz;122;-175;4275;11800;41;32;49;95;16;9;2;0;0;0;0;0;35.04;33.61;7.99;299.25;0;-175;1197;4788;5386.5;5985;7182
225;7lucky7;122;-525;5525;13900;46;44;32;99;16;6;1;0;0;0;0;0;45.29;37.7;16.14;386.75;0;-525;1547;6188;6961.5;7735;9282
226;Zagpak;122;50;3100;8950;42;38;42;94;16;10;0;2;0;0;0;0;25.41;34.43;3.76;217;0;50;868;3472;3906;4340;5208
227;NOACH95;121;-850;3800;10350;37;52;32;89;24;7;1;0;0;0;0;0;31.4;30.58;9.21;266;0;-850;1064;4256;4788;5320;6384
228;PACO&A&H;121;275;3275;8650;49;30;42;91;21;9;0;0;0;0;0;0;27.07;40.5;11.96;229.25;0;275;917;3668;4126.5;4585;5502
229;ALLIN_BABA;121;200;3900;10750;46;44;31;90;20;11;0;0;0;0;0;0;32.23;38.02;8.12;273;0;200;1092;4368;4914;5460;6552
230;allattin59;121;-250;3850;9800;43;30;48;97;14;10;0;0;0;0;0;0;31.82;35.54;15.15;269.5;0;-250;1078;4312;4851;5390;6468
231;corama;121;200;3450;10000;39;29;53;86;25;7;2;1;0;0;0;0;28.51;32.23;3.38;241.5;0;200;966;3864;4347;4830;5796
232;_KirbystacK_;121;-600;3650;9000;39;46;36;97;18;6;0;0;0;0;0;0;30.17;32.23;17.81;255.5;0;-600;1022;4088;4599;5110;6132
233;LucAS nOOb;120;-50;3800;9950;48;39;33;93;21;5;0;1;0;0;0;0;31.67;40;12.72;266;0;-50;1064;4256;4788;5320;6384
234;legrandgar;120;-25;3275;9100;48;39;33;91;19;8;2;0;0;0;0;0;27.29;40;7.38;229.25;0;-25;917;3668;4126.5;4585;5502
235;papitox;120;-150;3000;7800;45;34;41;93;18;9;0;0;0;0;0;0;25;37.5;13.33;210;0;-150;840;3360;3780;4200;5040
236;123Carte;120;1175;5675;16600;47;34;39;93;14;9;3;1;0;0;0;0;47.29;39.17;2.5;397.25;0;1175;1589;6356;7150.5;7945;9534
237;Don Curioso;119;-925;2975;7450;34;43;42;97;14;8;0;0;0;0;0;0;25;28.57;16.53;208.25;0;-925;833;3332;3748.5;4165;4998
238;latueuse38;119;550;3650;9850;45;27;47;91;20;6;2;0;0;0;0;0;30.67;37.82;10.05;255.5;0;550;1022;4088;4599;5110;6132
239;bil9;119;-275;3825;9650;45;25;49;96;12;11;0;0;0;0;0;0;32.14;37.82;15.9;267.75;0;-275;1071;4284;4819.5;5355;6426
240;CARAS;118;0;3000;9150;36;38;44;84;20;9;4;1;0;0;0;0;25.42;30.51;-1.67;210;0;0;840;3360;3780;4200;5040
241;vissan69;118;-300;3100;8000;43;30;45;92;18;8;0;0;0;0;0;0;26.27;36.44;13.98;217;0;-300;868;3472;3906;4340;5208
242;SharKKutier;118;-500;2950;7850;39;40;39;91;19;6;2;0;0;0;0;0;25;33.05;11.3;206.5;0;-500;826;3304;3717;4130;4956
243;ShAAAlom;118;-475;3325;8300;37;45;36;93;20;5;0;0;0;0;0;0;28.18;31.36;16.79;232.75;0;-475;931;3724;4189.5;4655;5586
244;marcaurel79;118;-875;2975;8450;36;43;39;81;27;9;1;0;0;0;0;0;25.21;30.51;5.32;208.25;0;-875;833;3332;3748.5;4165;4998
245;Pochon2Coke;118;0;2950;7700;48;30;40;93;16;8;1;0;0;0;0;0;25;40.68;12.99;206.5;0;0;826;3304;3717;4130;4956
246;TuCoElBrUtO;118;450;3000;7350;56;42;20;97;15;6;0;0;0;0;0;0;25.42;47.46;18.33;210;0;450;840;3360;3780;4200;5040
247;Fanoche83;118;1475;3775;11650;52;27;39;92;11;12;2;0;1;0;0;0;31.99;44.07;-2.87;264.25;0;1475;1057;4228;4756.5;5285;6342
248;Jean cule...;117;-25;3975;10650;42;47;28;87;22;7;1;0;0;0;0;0;33.97;35.9;10.69;278.25;0;-25;1113;4452;5008.5;5565;6678
249;Sir lewis;117;-1150;3650;10150;29;32;56;88;17;10;1;1;0;0;0;0;31.2;24.79;7.31;255.5;0;-1150;1022;4088;4599;5110;6132
250;crazyjoker29;117;125;3525;9550;38;47;32;88;18;10;1;0;0;0;0;0;30.13;32.48;9.69;246.75;0;125;987;3948;4441.5;4935;5922
251;serj13;117;525;4075;11300;40;30;47;86;15;16;0;0;0;0;0;0;34.83;34.19;7.57;285.25;0;525;1141;4564;5134.5;5705;6846
252;Klaks;116;150;3150;8550;45;29;42;86;19;10;1;0;0;0;0;0;27.16;38.79;9.52;220.5;0;150;882;3528;3969;4410;5292
253;TOELMADE;116;-225;3325;9250;40;35;41;84;23;8;1;0;0;0;0;0;28.66;34.48;7.27;232.75;0;-225;931;3724;4189.5;4655;5586
254;Pizdacje;116;-625;4225;11800;35;37;44;86;15;14;1;0;0;0;0;0;36.42;30.17;6.9;295.75;0;-625;1183;4732;5323.5;5915;7098
255;cyrilyes;115;-75;3725;9900;39;23;53;86;18;9;2;0;0;0;0;0;32.39;33.91;11.41;260.75;0;-75;1043;4172;4693.5;5215;6258
256;13  ALLIN13;115;-175;2875;7650;43;54;18;86;20;9;0;0;0;0;0;0;25;37.39;11.3;201.25;0;-175;805;3220;3622.5;4025;4830
257;-TCHETNIK-;114;-725;3025;7500;36;37;41;93;15;6;0;0;0;0;0;0;26.54;31.58;17.36;211.75;0;-725;847;3388;3811.5;4235;5082
258;All iiiiiiin;114;-175;3475;9200;33;44;37;84;22;6;2;0;0;0;0;0;30.48;28.95;11.75;243.25;0;-175;973;3892;4378.5;4865;5838
259;tonyno gypsi;114;450;4850;12800;43;29;42;87;19;7;1;0;0;0;0;0;42.54;37.72;12.03;339.5;0;450;1358;5432;6111;6790;8148
260;RAISE75;114;300;5450;14250;43;29;42;92;13;7;2;0;0;0;0;0;47.81;37.72;12.84;381.5;0;300;1526;6104;6867;7630;9156
261;Simbaaaaaaaa;114;1525;2975;8650;54;24;36;92;13;8;0;0;1;0;0;0;26.1;47.37;3.08;208.25;0;1525;833;3332;3748.5;4165;4998
262;lavinia83;113;-325;2825;7750;36;40;37;85;16;11;1;0;0;0;0;0;25;31.86;8.55;197.75;0;-325;791;3164;3559.5;3955;4746
263;Scaptelou;113;425;4075;11450;43;31;39;82;22;8;1;0;0;0;0;0;36.06;38.05;6.34;285.25;0;425;1141;4564;5134.5;5705;6846
264;Trafinoglu;113;825;2825;7800;53;32;28;84;19;8;2;0;0;0;0;0;25;46.9;7.96;197.75;0;825;791;3164;3559.5;3955;4746
265;vr68;112;-275;3125;8300;44;28;40;86;19;6;1;0;0;0;0;0;27.9;39.29;11.47;218.75;0;-275;875;3500;3937.5;4375;5250
266;elclem6;112;50;3100;8350;43;41;28;84;18;9;1;0;0;0;0;0;27.68;38.39;10.22;217;0;50;868;3472;3906;4340;5208
267;housbail44;112;-800;3300;8550;30;47;35;86;14;12;0;0;0;0;0;0;29.46;26.79;13.64;231;0;-800;924;3696;4158;4620;5544
268;Rest trankil;111;-175;2825;7400;42;37;32;89;13;8;1;0;0;0;0;0;25.45;37.84;12.68;197.75;0;-175;791;3164;3559.5;3955;4746
269;baffgirl;111;1000;3950;13600;44;35;32;80;21;7;1;1;1;0;0;0;35.59;39.64;-14.77;276.5;0;1000;1106;4424;4977;5530;6636
270;Newlife25;111;-500;3650;9950;36;34;41;84;18;9;0;0;0;0;0;0;32.88;32.43;9.13;255.5;0;-500;1022;4088;4599;5110;6132
271;vanvan690;110;500;5500;15100;44;26;40;76;27;7;0;0;0;0;0;0;50;40;8.48;385;0;500;1540;6160;6930;7700;9240
272;soso89;110;200;3650;9650;41;28;41;82;21;6;1;0;0;0;0;0;33.18;37.27;11.87;255.5;0;200;1022;4088;4599;5110;6132
273;pokerface737;110;-100;2800;6950;46;27;37;88;17;5;0;0;0;0;0;0;25.45;41.82;17.26;196;0;-100;784;3136;3528;3920;4704
274;M0cznyL0vPok;110;-600;2850;7900;32;39;39;79;24;5;2;0;0;0;0;0;25.91;29.09;7.6;199.5;0;-600;798;3192;3591;3990;4788
275;mario0000079;110;-250;2750;7150;39;46;25;86;15;9;0;0;0;0;0;0;25;35.45;13.33;192.5;0;-250;770;3080;3465;3850;4620
276;Tigrouwood1;109;-500;3200;8950;33;35;41;87;15;4;2;1;0;0;0;0;29.36;30.28;6.77;224;0;-500;896;3584;4032;4480;5376
277;Brazil2aa;109;-1925;5425;13850;25;30;54;84;20;5;0;0;0;0;0;0;49.77;22.94;14.9;379.75;0;-1925;1519;6076;6835.5;7595;9114
278;grenat57525;108;-200;2700;7000;42;34;32;87;14;5;2;0;0;0;0;0;25;38.89;13.58;189;0;-200;756;3024;3402;3780;4536
279;Bebine;108;25;3275;8900;38;25;45;81;17;10;0;0;0;0;0;0;30.32;35.19;9.41;229.25;0;25;917;3668;4126.5;4585;5502
280;squali44;108;100;5400;14200;39;41;28;83;16;9;0;0;0;0;0;0;50;36.11;12.35;378;0;100;1512;6048;6804;7560;9072
281;lokahi59;107;50;3950;9600;42;35;30;87;17;3;0;0;0;0;0;0;36.92;39.25;18.99;276.5;0;50;1106;4424;4977;5530;6636
282;arslanyosma;107;-650;3700;9550;34;23;50;83;16;7;1;0;0;0;0;0;34.58;31.78;13.96;259;0;-650;1036;4144;4662;5180;6216
283;kinerio;107;-400;4300;11800;36;22;49;77;22;7;1;0;0;0;0;0;40.19;33.64;8.53;301;0;-400;1204;4816;5418;6020;7224
284;alex0687;107;-400;2850;8150;33;47;27;77;19;8;3;0;0;0;0;0;26.64;30.84;4.68;199.5;0;-400;798;3192;3591;3990;4788
285;Sylange_974;107;-1250;3600;10050;26;51;30;74;24;8;1;0;0;0;0;0;33.64;24.3;6.94;252;0;-1250;1008;4032;4536;5040;6048
286;LEJOKERDU92;106;750;2650;7250;45;28;33;82;18;4;1;1;0;0;0;0;25;42.45;8.81;185.5;0;750;742;2968;3339;3710;4452
287;Lanesthesist;105;-450;3350;9650;30;39;36;78;12;15;0;0;0;0;0;0;31.9;28.57;3.98;234.5;0;-450;938;3752;4221;4690;5628
288;s.timmerman;105;1250;3350;10100;39;35;31;78;13;11;2;1;0;0;0;0;31.9;37.14;-0.5;234.5;0;1250;938;3752;4221;4690;5628
289;Super Red;104;-500;3350;8600;35;26;43;81;15;8;0;0;0;0;0;0;32.21;33.65;14.43;234.5;0;-500;938;3752;4221;4690;5628
290;Potchozer;104;375;2775;7300;45;30;29;78;19;7;0;0;0;0;0;0;26.68;43.27;12.31;194.25;0;375;777;3108;3496.5;3885;4662
291;essoulami22;104;275;3625;9300;40;26;38;78;21;5;0;0;0;0;0;0;34.86;38.46;14.48;253.75;0;275;1015;4060;4567.5;5075;6090
292;narcisse86;104;-450;2600;7150;30;34;40;77;15;12;0;0;0;0;0;0;25;28.85;8.33;182;0;-450;728;2912;3276;3640;4368
293;carreKKKK;103;-125;2625;7250;38;29;36;79;15;6;3;0;0;0;0;0;25.49;36.89;7.94;183.75;0;-125;735;2940;3307.5;3675;4410
294;caxazoli;103;-450;5150;13400;37;31;35;81;15;6;1;0;0;0;0;0;50;35.92;13.27;360.5;0;-450;1442;5768;6489;7210;8652
295;bnak;103;-100;3950;11150;38;32;33;73;18;11;1;0;0;0;0;0;38.35;36.89;5.91;276.5;0;-100;1106;4424;4977;5530;6636
296;rocoto;103;250;2700;7650;38;24;41;73;20;8;2;0;0;0;0;0;26.21;36.89;5.56;189;0;250;756;3024;3402;3780;4536
297;Easy.X;102;-600;3350;9000;30;31;41;79;13;9;1;0;0;0;0;0;32.84;29.41;10.45;234.5;0;-600;938;3752;4221;4690;5628
298;Dals159;102;-300;3500;9350;37;38;27;76;19;6;1;0;0;0;0;0;34.31;36.27;10.95;245;0;-300;980;3920;4410;4900;5880
299;Bru148;102;25;3175;8250;38;32;32;78;17;7;0;0;0;0;0;0;31.13;37.25;13.39;222.25;0;25;889;3556;4000.5;4445;5334
300;81RITA;101;300;2550;6500;41;25;35;78;20;2;1;0;0;0;0;0;25.25;40.59;15.03;178.5;0;300;714;2856;3213;3570;4284
301;f.dup44;101;-200;3500;8650;38;29;34;81;14;6;0;0;0;0;0;0;34.65;37.62;17.62;245;0;-200;980;3920;4410;4900;5880
302;PICTOU13;100;-475;2875;7800;36;26;38;74;17;8;1;0;0;0;0;0;28.75;36;9.57;201.25;0;-475;805;3220;3622.5;4025;4830
303;bastery11;100;-250;2550;7200;31;40;29;74;15;9;2;0;0;0;0;0;25.5;31;5.88;178.5;0;-250;714;2856;3213;3570;4284
304;Ectosdeblaes;100;-350;2600;6600;32;33;35;82;12;5;1;0;0;0;0;0;26;32;15.38;182;0;-350;728;2912;3276;3640;4368
305;lesombre09;100;-700;2750;6850;29;31;40;82;12;6;0;0;0;0;0;0;27.5;29;16.97;192.5;0;-700;770;3080;3465;3850;4620
306;Pit09;100;325;2725;7100;43;30;27;78;16;4;2;0;0;0;0;0;27.25;43;13.15;190.75;0;325;763;3052;3433.5;3815;4578
307;kraweed62;100;700;3950;9900;48;25;27;79;15;6;0;0;0;0;0;0;39.5;48;16.46;276.5;0;700;1106;4424;4977;5530;6636
